AC	AC
AU	AU
AI	AI
AO	AO
OA	OA
AN	AN
ANH	ANH
ANG	ANG
AM	AM
AP	AP
AT	AT
AY	AY
OAC	OAC
OACH	OACH
OAI	OAI
OAT	OAT
OAN	OAN
OANH	OANH
OANG	OANG
AS	Á
ACS	ÁC
ACHS	ÁCH
ATS	ÁT
APS	ÁP
AUS	ÁU
AIS	ÁI
AOS	ÁO
OAS	OÁ
ANS	ÁN
ANHS	ÁNH
ANGS	ÁNG
AMS	ÁM
AYS	ÁY
OACS	OÁC
OACHS	OÁCH
OAIS	OÁI
OATS	OÁT
OANS	OÁN
OANHS	OÁNH
OANGS	OÁNG
OASS	OAS
ASS	AS
AUSS	AUS
APSS	APS
AMSS	AMS
ANSS	ANS
OACSS	OACS
ACHSS	ACHS
APSS	APS
AF	À
ACF	ÀC
ACHF	ÀCH
ATF	ÀT
APF	ÀP
AUF	ÀU
AIF	ÀI
AOF	ÀO
OAF	OÀ
ANF	ÀN
ANHF	ÀNH
ANGF	ÀNG
AMF	ÀM
AY	AY
AYF	ÀY
OACF	OÀC
OACHF	OÀCH
OAIF	OÀI
OATF	OÀT
OANF	OÀN
OANHF	OÀNH
OANGF	OÀNG
AFF	AF
AR	Ả
ACR	ẢC
ACHR	ẢCH
ATR	ẢT
APR	ẢP
AUR	ẢU
AIR	ẢI
AOR	ẢO
OAR	OẢ
ANR	ẢN
ANHR	ẢNH
ANGR	ẢNG
AMR	ẢM
AYR	ẢY
OACR	OẢC
OACHR	OẢCH
OAIR	OẢI
OATR	OẢT
OANR	OẢN
OANHR	OẢNH
OANGR	OẢNG
ARR	AR
ACRR	ACR
ATRR	ATR
AURR	AUR
AX	Ã
ACX	ÃC
ACHX	ÃCH
ATX	ÃT
APX	ÃP
AUX	ÃU
AIX	ÃI
AOX	ÃO
OAX	OÃ
ANX	ÃN
ANHX	ÃNH
ANGX	ÃNG
AMX	ÃM
AYX	ÃY
OACX	OÃC
OACHX	OÃCH
OAIX	OÃI
OATX	OÃT
OANX	OÃN
OANHX	OÃNH
OANGX	OÃNG
AXX	AX
AUXX	AUX
AIXX	AIX
ATXX	ATX
AJ	Ạ
ACJ	ẠC
ACHJ	ẠCH
ATJ	ẠT
APJ	ẠP
AUJ	ẠU
AIJ	ẠI
AOJ	ẠO
OAJ	OẠ
ANJ	ẠN
ANHJ	ẠNH
ANGJ	ẠNG
AMJ	ẠM
AYJ	ẠY
OACJ	OẠC
OACHJ	OẠCH
OAIJ	OẠI
OATJ	OẠT
OANJ	OẠN
OANGJ	OẠNH
OANHJ	OẠNG
AJJ	AJ
ACJJ	ACJ
AA	Â
AAM	ÂM
AAU	ÂU
AAN	ÂN
AAY	ÂY
AANG	ÂNG
UAAT	UÂT
UAAN	UÂN
UAANG	UÂNG
AAA	AA
AAS	Ấ
AACS	ẤC
AATS	ẤT
AAPS	ẤP
AAUS	ẤU
AANS	ẤN
AANGS	ẤNG
AAMS	ẤM
AAYS	ẤY
UAATS	UẤT
UAANS	UẤN
UAANGS	UẤNG
AAF	Ầ
AACF	ẦC
AATF	ẦT
AAPF	ẦP
AAUF	ẦU
AANF	ẦN
AANGF	ẦNG
AAMF	ẦM
AAYF	ẦY
UAATF	UẦT
UAANF	UẦN
UAANGF	UẦNG
AAR	Ẩ
AACR	ẨC
AATR	ẨT
AAPR	ẨP
AAUR	ẨU
AANR	ẨN
AANGR	ẨNG
AAMR	ẨM
AAYR	ẨY
UAATR	UẨT
UAANR	UẨN
UAANGR	UẨNG
AAX	Ẫ
AACX	ẪC
AATX	ẪT
AAPX	ẪP
AAUX	ẪU
AANX	ẪN
AANGX	ẪNG
AAMX	ẪM
AAYX	ẪY
UAATX	UẪT
UAANX	UẪN
UAANGX	UẪNG
AAJ	Ậ
AACJ	ẬC
AATJ	ẬT
AAPJ	ẬP
AAUJ	ẬU
AANJ	ẬN
AANGJ	ẬNG
AAMJ	ẬM
AAYJ	ẬY
UAATJ	UẬT
UAANJ	UẬN
UAANGJ	UẬNG
AW	Ă
AWN	ĂN
AWNG	ĂNG
AWM	ĂM
OAWN	OĂN
OAWT	OĂT
AWW	AW
AWS	Ắ
AWCS	ẮC
AWTS	ẮT
AWPS	ẮP
AWNS	ẮN
AWNGS	ẮNG
AWMS	ẮM
OAWS	OẮ
OAWNS	OẮN
OAWTS	OẮT
OAWCS	OẮC
AWF	Ằ
AWCF	ẰC
AWTF	ẰT
AWPF	ẰP
AWNF	ẰN
AWNGF	ẰNG
AWMF	ẰM
OAWF	OẰ
OAWNF	OẰN
OAWTF	OẰT
AWR	Ẳ
AWCR	ẲC
AWTR	ẲT
AWPR	ẲP
AWNR	ẲN
AWNGR	ẲNG
AWMR	ẲM
OAWR	OẲ
OAWNR	OẲN
OAWTR	OẲT
AWX	Ẵ
AWCX	ẴC
AWTX	ẴT
AWPX	ẴP
AWNX	ẴN
AWNGX	ẴNG
AWMX	ẴM
OAWX	OẴ
OAWNX	OẴN
OAWTX	OẴT
AWJ	Ặ
AWCJ	ẶC
AWTJ	ẶT
AWPJ	ẶP
AWNJ	ẶN
AWNGJ	ẶNG
AWMJ	ẶM
OAWJ	OẶ
OAWNJ	OẶN
OAWTJ	OẶT
OAWCJ	OẶC
EO	EO
OE	OE
EN	EN
EM	EM
ET	ET
EC	EC
EP	EP
ES	É
ECS	ÉC
ETS	ÉT
EPS	ÉP
EOS	ÉO
OES	OÉ
OETS	OÉT
ENS	ÉN
EMS	ÉM
ESS	ES
ECSS	ECS
ETSS	ETS
EPSS	EPS
ENSS	ENS
EMSS	EMS
EF	È
ECF	ÈC
ETF	ÈT
EPF	ÈP
EOF	ÈO
OEF	OÈ
ENF	ÈN
EMF	ÈM
EFF	EF
ECFF	ECF
ETFF	ETF
OEFF	OEF
ER	Ẻ
ECR	ẺC
ETR	ẺT
EPR	ẺP
EOR	ẺO
OER	OẺ
ENR	ẺN
EMR	ẺM
ERR	ER
ECRR	ECR
ETRR	ETR
OERR	OER
EX	Ẽ
ECX	ẼC
ETX	ẼT
EPX	ẼP
EOX	ẼO
OEX	OẼ
ENX	ẼN
EMX	ẼM
EXX	EX
EJ	Ẹ
ECJ	ẸC
ETJ	ẸT
EPJ	ẸP
EOJ	ẸO
OEJ	OẸ
ENJ	ẸN
EMJ	ẸM
EJJ	EJ
EE	Ê
EEU	ÊU
EEN	ÊN
EENH	ÊNH
EEM	ÊM
IEEN	IÊN
IEENG	IÊNG
IEEM	IÊM
IEEC	IÊC
IEEU	IÊU
IEEP	IÊP
YEEN	YÊN
YEENG	YÊNG
YEEM	YÊM
YEET	YÊT
YEEU	YÊU
UYEET	UYÊT
UYEEN	UYÊN
EEE	EE
IE	IE
YE	YE
EES	Ế
EETS	ẾT
EEUS	ẾU
EEPS	ẾP
EECHS	ẾCH
EENS	ẾN
EEMS	ẾM
IEES	IẾ
IEETS	IẾT
IEEST	IẾT
IEENS	IẾN
EENGS	ẾNG
IEENGS	IẾNG
IEEMS	IẾM
IEECS	IẾC
IEEUS	IẾU
IEEPS	IẾP
YEES	YẾ
YEENS	YẾN
YEENGS	YẾNG
YEEMS	YẾM
YEETS	YẾT
YEEST	YẾT
YEEUS	YẾU
UYEES	UYẾ
UYEETS	UYẾT
UYEENS	UYẾN
IE	IE
EESS	EES
EENSS	EENS
EETSS	EETS
EEPSS	EEPS
EEF	Ề
EEUF	ỀU
EEPF	ỀP
EENF	ỀN
EENHF	ỀNH
EEMF	ỀM
IEEF	IỀ
IEENF	IỀN
IEENGF	IỀNG
IEEMF	IỀM
IEECF	IỀC
IEEUF	IỀU
IEEPF	IỀP
YEEF	YỀ
YEENF	YỀN
YEENGF	YỀNG
YEEMF	YỀM
YEETF	YỀT
YEEUF	YỀU
UYEEF	UYỀ
UYEETF	UYỀT
UYEENF	UYỀN
EER	Ể
EETR	ỂT
EEUR	ỂU
EEPR	ỂP
EENR	ỂN
EENHR	ỂNH
EEMR	ỂM
IEER	IỂ
IEENR	IỂN
IEENGR	IỂNG
IEEMR	IỂM
IEECR	IỂC
IEEUR	IỂU
IEEPR	IỂP
YEENR	YỂN
YEENGR	YỂNG
YEEMR	YỂM
YEETR	YỂT
YEEUR	YỂU
UYEETR	UYỂT
UYEENR	UYỂN
UYEERN	UYỂN
EERR	EER
EEX	Ễ
EETX	ỄT
EEUX	ỄU
EEPX	ỄP
EENX	ỄN
EEMX	ỄM
IEEX	IỄ
IEENX	IỄN
IEENGX	IỄNG
IEEMX	IỄM
IEECX	IỄC
IEEUX	IỄU
IEEPX	IỄP
YEENX	YỄN
YEENGX	YỄNG
YEEMX	YỄM
YEETX	YỄT
YEEUX	YỄU
UYEETX	UYỄT
UYEENX	UYỄN
UYEEXN	UYỄN
EEJ	Ệ
EETJ	ỆT
EEUJ	ỆU
EEPJ	ỆP
EENJ	ỆN
EENHJ	ỆNH
EECHJ	ỆCH
EECJH	ỆCH
EEMJ	ỆM
IEEJ	IỆ
IEETJ	IỆT
IEEJT	IỆT
IEENJ	IỆN
IEENGJ	IỆNG
IEEMJ	IỆM
IEECJ	IỆC
IEEUJ	IỆU
IEEPJ	IỆP
YEENJ	YỆN
YEENGJ	YỆNG
YEEMJ	YỆM
YEETJ	YỆT
YEEUJ	YỆU
UYEETJ	UYỆT
UYEENJ	UYỆN
UYEEJN	UYỆN
OI	OI
OOO	OO
OC	OC
ON	ON
ONG	ONG
OM	OM
OT	OT
OP	OP
OS	Ó
OTS	ÓT
OIS	ÓI
OOOS	OÓ
OPS	ÓP
OCS	ÓC
ONS	ÓN
ONGS	ÓNG
OMS	ÓM
OSS	OS
OTSS	OTS
OISS	OIS
OPSS	OPS
ONSS	ONS
OMSS	OMS
OF	Ò
OTF	ÒT
OIF	ÒI
OOOF	OÒ
OPF	ÒP
OCF	ÒC
ONF	ÒN
ONGF	ÒNG
OMF	ÒM
OFF	OF
OTFF	OTF
OPFF	OPF
ONFF	ONF
OMFF	OMF
OR	Ỏ
OTR	ỎT
OIR	ỎI
OOOR	OỎ
OPR	ỎP
OCR	ỎC
ONR	ỎN
ONGR	ỎNG
OMR	ỎM
ORR	OR
OX	Õ
OTX	ÕT
OIX	ÕI
OOOX	OÕ
OPX	ÕP
OCX	ÕC
ONX	ÕN
ONGX	ÕNG
OMX	ÕM
OXX	OX
OJ	Ọ
OTJ	ỌT
OIJ	ỌI
OOOJ	OỌ
OPJ	ỌP
OCJ	ỌC
ONJ	ỌN
ONGJ	ỌNG
OMJ	ỌM
OO	Ô
OOC	ÔC
OOT	ÔT
OOP	ÔP
OON	ÔN
OONG	ÔNG
OOM	ÔM
OOI	ÔI
UOOI	UÔI
UOOC	UÔC
UOOT	UÔT
UOON	UÔN
UOONG	UÔNG
UOOM	UÔM
OOS	Ố
OOCS	ỐC
OOTS	ỐT
OOPS	ỐP
OONS	ỐN
OONGS	ỐNG
OOMS	ỐM
OOIS	ỐI
UOOIS	UỐI
UOOSI	UỐI
UOOCS	UỐC
UOOSC	UỐC
UOOTS	UỐT
UOONS	UỐN
UOONGS	UỐNG
UOOMS	UỐM
OOTSS	OOTS
OOF	Ồ
OOCF	ỒC
OOTF	ỒT
OOPF	ỒP
OONF	ỒN
OONGF	ỒNG
OOMF	ỒM
OOIF	ỒI
UOOCF	UỒC
UOOTF	UỒT
UOONF	UỒN
UOONGF	UỒNG
UOOMF	UỒM
OOR	Ổ
OOCR	ỔC
OOTR	ỔT
OOPR	ỔP
OONR	ỔN
OONGR	ỔNG
OOMR	ỔM
OOIR	ỔI
UOOIR	UỔI
UOOCR	UỔC
UOOTR	UỔT
UOONR	UỔN
UOONGR	UỔNG
UOOMR	UỔM
OOX	Ỗ
OOCX	ỖC
OOTX	ỖT
OOPX	ỖP
OONX	ỖN
OONGX	ỖNG
OOMX	ỖM
OOIX	ỖI
UOOIX	UỖI
UOOCX	UỖC
UOOTX	UỖT
UOONX	UỖN
UOONGX	UỖNG
UOOMX	UỖM
OOJ	Ộ
OOCJ	ỘC
OOTJ	ỘT
OOPJ	ỘP
OONJ	ỘN
OONGJ	ỘNG
OOMJ	ỘM
OOIJ	ỘI
UOOIJ	UỘI
UOOJI	UỘI
UOOCJ	UỘC
UOOJC	UỘC
UOOTJ	UỘT
UOONJ	UỘN
UOONGJ	UỘNG
UOOMJ	UỘM
OW	Ơ
OWT	ƠT
OWP	ƠP
OWN	ƠN
OWM	ƠM
OWI	ƠI
UOWC	ƯƠC
WOWC	ƯƠC
UWOWC	ƯƠC
UOWI	ƯƠI
WOWI	ƯƠI
UWOWI	ƯƠI
UOWT	ƯƠT
WOWT	ƯƠT
UWOWT	ƯƠT
UOWP	ƯƠP
WOWP	ƯƠP
UWOWP	ƯƠP
UOWN	ƯƠN
WOWN	ƯƠN
UWOWN	ƯƠN
UOWM	ƯƠM
WOWM	ƯƠM
UWOWM	ƯƠM
UWOWU	ƯƠU
UOWNG	ƯƠNG
WOWNG	ƯƠNG
UWOWNG	ƯƠNG
OWW	OW
WO	WO
OWS	Ớ
OWTS	ỚT
OWPS	ỚP
OWNS	ỚN
OWMS	ỚM
OWIS	ỚI
UOWS	ƯỚ
WOWS	ƯỚ
UWOWS	ƯỚ
UOWCS	ƯỚC
WOWCS	ƯỚC
UWOWCS	ƯỚC
UOWIS	ƯỚI
WOWIS	ƯỚI
UWOWIS	ƯỚI
UOWTS	ƯỚT
WOWTS	ƯỚT
UWOWTS	ƯỚT
UOWPS	ƯỚP
WOWPS	ƯỚP
UWOWPS	ƯỚP
UOWNS	ƯỚN
WOWNS	ƯỚN
UWOWNS	ƯỚN
UOWMS	ƯỚM
WOWMS	ƯỚM
UWOWMS	ƯỚM
UWOWUS	ƯỚU
UOWCS	ƯỚNG
WOWNGS	ƯỚNG
UWOWNGS	ƯỚNG
OWSS	OWS
OWF	Ờ
OWTF	ỜT
OWPF	ỜP
OWNF	ỜN
OWMF	ỜM
OWIF	ỜI
UOWF	ƯỜ
WOWF	ƯỜ
UWOWF	ƯỜ
UOWTF	ƯỜT
WOWTF	ƯỜT
UWOWTF	ƯỜT
UOWIF	ƯỜI
WOWIF	ƯỜI
UWOWIF	ƯỜI
UOWPF	ƯỜP
WOWPF	ƯỜP
UWOWPF	ƯỜP
UOWNF	ƯỜN
WOWNF	ƯỜN
UWOWNF	ƯỜN
UOWMF	ƯỜM
WOWMF	ƯỜM
UWOWMF	ƯỜM
UOWNGF	ƯỜNG
WOWNGF	ƯỜNG
UWOWNGF	ƯỜNG
OWFF	OWF
OWR	Ở
OWTR	ỞT
OWPR	ỞP
OWNR	ỞN
OWMR	ỞM
OWIR	ỞI
UOWR	ƯỞ
WOWR	ƯỞ
UWOWR	ƯỞ
UOWTR	ƯỞT
WOWTR	ƯỞT
UWOWTR	ƯỞT
UOWIR	ƯỞI
WOWIR	ƯỞI
UWOWIR	ƯỞI
UOWPR	ƯỞP
WOWPR	ƯỞP
UWOWPR	ƯỞP
UOWNR	ƯỞN
WOWNR	ƯỞN
UWOWNR	ƯỞN
UOWMR	ƯỞM
WOWMR	ƯỞM
UWOWMR	ƯỞM
UOWNGR	ƯỞNG
WOWNGR	ƯỞNG
UWOWNGR	ƯỞNG
OWRR	OWR
OWX	Ỡ
OWTX	ỠT
OWPX	ỠP
OWNX	ỠN
OWMX	ỠM
OWIX	ỠI
UOWX	ƯỠ
WOWX	ƯỠ
UWOWX	ƯỠ
UOWTX	ƯỠT
WOWTX	ƯỠT
UWOWTX	ƯỠT
UOWIX	ƯỠI
WOWIX	ƯỠI
UWOWIX	ƯỠI
UOWPX	ƯỠP
WOWPX	ƯỠP
UWOWPX	ƯỠP
UOWNX	ƯỠN
WOWNX	ƯỠN
UWOWNX	ƯỠN
UOWMX	ƯỠM
WOWMX	ƯỠM
UWOWMX	ƯỠM
UOWNGX	ƯỠNG
WOWNGX	ƯỠNG
UWOWNGX	ƯỠNG
OWXX	OWX
OWJ	Ợ
OWTJ	ỢT
OWPJ	ỢP
OWNJ	ỢN
OWMJ	ỢM
OWIJ	ỢI
UOWJ	ƯỢ
WOWJ	ƯỢ
UWOWJ	ƯỢ
UOWTJ	ƯỢT
WOWTJ	ƯỢT
UWOWTJ	ƯỢT
UOWIJ	ƯỢI
WOWIJ	ƯỢI
UWOWIJ	ƯỢI
UOWPJ	ƯỢP
WOWPJ	ƯỢP
UWOWPJ	ƯỢP
UOWCJ	ƯỢC
WOWCJ	ƯỢC
UWOWCJ	ƯỢC
UOWNJ	ƯỢN
WOWNJ	ƯỢN
UWOWNJ	ƯỢN
UOWMJ	ƯỢM
WOWMJ	ƯỢM
UWOWMJ	ƯỢM
UWOWUJ	ƯỢU
UOWNGJ	ƯỢNG
WOWNGJ	ƯỢNG
UWOWNGJ	ƯỢNG
OWJJ	OWJ
UI	UI
UP	UP
UT	UT
UY	UY
UA	UA
UC	UC
UN	UN
UM	UM
UNG	UNG
UO	UO
US	Ú
UIS	ÚI
UPS	ÚP
UTS	ÚT
UAS	ÚA
UCS	ÚC
UNS	ÚN
UMS	ÚM
UNGS	ÚNG
USS	US
UF	Ù
UIF	ÙI
UAF	ÙA
UNF	ÙN
UMF	ÙM
UNGF	ÙNG
UFF	UF
UIFF	UIF
UAFF	UAF
UNFF	UNF
UMFF	UMF
UR	Ủ
UIR	ỦI
UAR	ỦA
UNR	ỦN
UMR	ỦM
UNGR	ỦNG
URR	UR
UNRR	UNR
UMRR	UMR
UX	Ũ
UIX	ŨI
UAX	ŨA
UNX	ŨN
UMX	ŨM
UNGX	ŨNG
UXX	UX
UAXX	UAX
UNXX	UNX
UMXX	UMX
UJ	Ụ
UIJ	ỤI
UAJ	ỤA
UNJ	ỤN
UMJ	ỤM
UNGJ	ỤNG
UTJ	ỤT
UCJ	ỤC
UPJ	ỤP
UJJ	UJ
UNJJ	UNJ
UMJJ	UMJ
UW	Ư
UWI	ƯI
UWA	ƯA
UWN	ƯN
UWNG	ƯNG
UWC	ƯC
UWU	ƯU
UWW	UW
UWS	Ứ
UWAS	ỨA
UWNGS	ỨNG
UWTS	ỨT
UWCS	ỨC
UWUS	ỨU
UWF	Ừ
UWAF	ỪA
UWNGF	ỪNG
UWUF	ỪU
UWR	Ử
UWIR	ỬI
UWAR	ỬA
UWNGR	ỬNG
UWUR	ỬU
UWX	Ữ
UWAX	ỮA
UWNX	ỮN
UWNGX	ỮNG
UWUX	ỮU
UWJ	Ự
UWAJ	ỰA
UWNGJ	ỰNG
UWUJ	ỰU
UWCJ	ỰC
GI	GI
IA	IA
IT	IT
IP	IP
IC	IC
IN	IN
IU	IU
IM	IM
INH	INH
ICH	ICH
IS	Í
IAS	ÍA
ICS	ÍC
ITS	ÍT
IPS	ÍP
ICHS	ÍCH
INS	ÍN
IUS	ÍU
IMS	ÍM
INHS	ÍNH
ISS	IS
IASS	IAS
ICSS	ICS
ITSS	ITS
INSS	INS
IPSS	IPS
IF	Ì
IAF	ÌA
INF	ÌN
IMF	ÌM
INHF	ÌNH
IUF	ÌU
GIF	GÌ
IFF	IF
IAFF	IAF
INFF	INF
IMFF	IMF
IUFF	IUF
GIFF	GIF
IR	Ỉ
IAR	ỈA
INR	ỈN
IMR	ỈM
INHR	ỈNH
IUR	ỈU
GIR	GỈ
IRR	IR
IARR	IAR
INRR	INR
IMRR	IMR
INHRR	INHR
IURR	IUR
GIRR	GIR
IX	Ĩ
IAX	ĨA
INX	ĨN
IMX	ĨM
INHX	ĨNH
IUX	ĨU
IXX	IX
IAXX	IAX
INXX	INX
IMXX	IMX
INHXX	INHX
IUXX	IUX
IJ	Ị
IAJ	ỊA
INJ	ỊN
IMJ	ỊM
IPJ	ỊP
INHJ	ỊNH
ITJ	ỊT
ICHJ	ỊCH
ICJH	ỊCH
IUJ	ỊU
ICJJ	ICJ
INJJ	INJ
IPJJ	IPJ
ITJJ	ITJ
ICHJJ	ICHJ
IUJJ	IUJ
UY	UY
UYNH	UYNH
UYT	UYT
UYCH	UYCH
YS	Ý
YNHS	ÝNH
UYS	UÝ
UYNHS	UÝNH
UYTS	UÝT
UYCHS	UÝCH
YSS	YS
YF	Ỳ
YNHF	ỲNH
UYF	UỲ
UYNHF	UỲNH
UYCHF	UỲCH
YR	Ỷ
UYR	UỶ
UYCHR	UỶCH
YX	Ỹ
UYX	UỸ
YJ	Ỵ
UYJ	UỴ
UYTJ	UỴT
UYCHJ	UỴCH
DD	Đ
DDD	DD
QU	QU
Ac	Ac
Au	Au
Ai	Ai
Ao	Ao
Oa	Oa
An	An
Anh	Anh
Ang	Ang
Am	Am
Ap	Ap
At	At
Ay	Ay
Oac	Oac
Oach	Oach
Oai	Oai
Oat	Oat
Oan	Oan
Oanh	Oanh
Oang	Oang
As	Á
Acs	Ác
Achs	Ách
Ats	Át
Aps	Áp
Aus	Áu
Ais	Ái
Aos	Áo
Oas	Oá
Ans	Án
Anhs	Ánh
Angs	Áng
Ams	Ám
Ays	Áy
Oacs	Oác
Oachs	Oách
Oais	Oái
Oats	Oát
Oans	Oán
Oanhs	Oánh
Oangs	Oáng
Oass	Oas
Ass	As
Auss	Aus
Apss	Aps
Amss	Ams
Anss	Ans
Oacss	Oacs
Achss	Achs
Apss	Aps
Af	À
Acf	Àc
Achf	Àch
Atf	Àt
Apf	Àp
Auf	Àu
Aif	Ài
Aof	Ào
Oaf	Oà
Anf	Àn
Anhf	Ành
Angf	Àng
Amf	Àm
Ay	Ay
Ayf	Ày
Oacf	Oàc
Oachf	Oàch
Oaif	Oài
Oatf	Oàt
Oanf	Oàn
Oanhf	Oành
Oangf	Oàng
Aff	Af
Ar	Ả
Acr	Ảc
Achr	Ảch
Atr	Ảt
Apr	Ảp
Aur	Ảu
Air	Ải
Aor	Ảo
Oar	Oả
Anr	Ản
Anhr	Ảnh
Angr	Ảng
Amr	Ảm
Ayr	Ảy
Oacr	Oảc
Oachr	Oảch
Oair	Oải
Oatr	Oảt
Oanr	Oản
Oanhr	Oảnh
Oangr	Oảng
Arr	Ar
Acrr	Acr
Atrr	Atr
Aurr	Aur
Ax	Ã
Acx	Ãc
Achx	Ãch
Atx	Ãt
Apx	Ãp
Aux	Ãu
Aix	Ãi
Aox	Ão
Oax	Oã
Anx	Ãn
Anhx	Ãnh
Angx	Ãng
Amx	Ãm
Ayx	Ãy
Oacx	Oãc
Oachx	Oãch
Oaix	Oãi
Oatx	Oãt
Oanx	Oãn
Oanhx	Oãnh
Oangx	Oãng
Axx	Ax
Auxx	Aux
Aixx	Aix
Atxx	Atx
Aj	Ạ
Acj	Ạc
Achj	Ạch
Atj	Ạt
Apj	Ạp
Auj	Ạu
Aij	Ại
Aoj	Ạo
Oaj	Oạ
Anj	Ạn
Anhj	Ạnh
Angj	Ạng
Amj	Ạm
Ayj	Ạy
Oacj	Oạc
Oachj	Oạch
Oaij	Oại
Oatj	Oạt
Oanj	Oạn
Oangj	Oạnh
Oanhj	Oạng
Ajj	Aj
Acjj	Acj
Aa	Â
Aam	Âm
Aau	Âu
Aan	Ân
Aay	Ây
Aang	Âng
Uaat	Uât
Uaan	Uân
Uaang	Uâng
Aaa	Aa
Aas	Ấ
Aacs	Ấc
Aats	Ất
Aaps	Ấp
Aaus	Ấu
Aans	Ấn
Aangs	Ấng
Aams	Ấm
Aays	Ấy
Uaats	Uất
Uaans	Uấn
Uaangs	Uấng
Aaf	Ầ
Aacf	Ầc
Aatf	Ầt
Aapf	Ầp
Aauf	Ầu
Aanf	Ần
Aangf	Ầng
Aamf	Ầm
Aayf	Ầy
Uaatf	Uầt
Uaanf	Uần
Uaangf	Uầng
Aar	Ẩ
Aacr	Ẩc
Aatr	Ẩt
Aapr	Ẩp
Aaur	Ẩu
Aanr	Ẩn
Aangr	Ẩng
Aamr	Ẩm
Aayr	Ẩy
Uaatr	Uẩt
Uaanr	Uẩn
Uaangr	Uẩng
Aax	Ẫ
Aacx	Ẫc
Aatx	Ẫt
Aapx	Ẫp
Aaux	Ẫu
Aanx	Ẫn
Aangx	Ẫng
Aamx	Ẫm
Aayx	Ẫy
Uaatx	Uẫt
Uaanx	Uẫn
Uaangx	Uẫng
Aaj	Ậ
Aacj	Ậc
Aatj	Ật
Aapj	Ập
Aauj	Ậu
Aanj	Ận
Aangj	Ậng
Aamj	Ậm
Aayj	Ậy
Uaatj	Uật
Uaanj	Uận
Uaangj	Uậng
Aw	Ă
Awn	Ăn
Awng	Ăng
Awm	Ăm
Oawn	Oăn
Oawt	Oăt
Aww	Aw
Aws	Ắ
Awcs	Ắc
Awts	Ắt
Awps	Ắp
Awns	Ắn
Awngs	Ắng
Awms	Ắm
Oaws	Oắ
Oawns	Oắn
Oawts	Oắt
Oawcs	Oắc
Awf	Ằ
Awcf	Ằc
Awtf	Ằt
Awpf	Ằp
Awnf	Ằn
Awngf	Ằng
Awmf	Ằm
Oawf	Oằ
Oawnf	Oằn
Oawtf	Oằt
Awr	Ẳ
Awcr	Ẳc
Awtr	Ẳt
Awpr	Ẳp
Awnr	Ẳn
Awngr	Ẳng
Awmr	Ẳm
Oawr	Oẳ
Oawnr	Oẳn
Oawtr	Oẳt
Awx	Ẵ
Awcx	Ẵc
Awtx	Ẵt
Awpx	Ẵp
Awnx	Ẵn
Awngx	Ẵng
Awmx	Ẵm
Oawx	Oẵ
Oawnx	Oẵn
Oawtx	Oẵt
Awj	Ặ
Awcj	Ặc
Awtj	Ặt
Awpj	Ặp
Awnj	Ặn
Awngj	Ặng
Awmj	Ặm
Oawj	Oặ
Oawnj	Oặn
Oawtj	Oặt
Oawcj	Oặc
Eo	Eo
Oe	Oe
En	En
Em	Em
Et	Et
Ec	Ec
Ep	Ep
Es	É
Ecs	Éc
Ets	Ét
Eps	Ép
Eos	Éo
Oes	Oé
Oets	Oét
Ens	Én
Ems	Ém
Ess	Es
Ecss	Ecs
Etss	Ets
Epss	Eps
Enss	Ens
Emss	Ems
Ef	È
Ecf	Èc
Etf	Èt
Epf	Èp
Eof	Èo
Oef	Oè
Enf	Èn
Emf	Èm
Eff	Ef
Ecff	Ecf
Etff	Etf
Oeff	Oef
Er	Ẻ
Ecr	Ẻc
Etr	Ẻt
Epr	Ẻp
Eor	Ẻo
Oer	Oẻ
Enr	Ẻn
Emr	Ẻm
Err	Er
Ecrr	Ecr
Etrr	Etr
Oerr	Oer
Ex	Ẽ
Ecx	Ẽc
Etx	Ẽt
Epx	Ẽp
Eox	Ẽo
Oex	Oẽ
Enx	Ẽn
Emx	Ẽm
Exx	Ex
Ej	Ẹ
Ecj	Ẹc
Etj	Ẹt
Epj	Ẹp
Eoj	Ẹo
Oej	Oẹ
Enj	Ẹn
Emj	Ẹm
Ejj	Ej
Ee	Ê
Eeu	Êu
Een	Ên
Eenh	Ênh
Eem	Êm
Ieen	Iên
Ieeng	Iêng
Ieem	Iêm
Ieec	Iêc
Ieeu	Iêu
Ieep	Iêp
Yeen	Yên
Yeeng	Yêng
Yeem	Yêm
Yeet	Yêt
Yeeu	Yêu
Uyeet	Uyêt
Uyeen	Uyên
Eee	Ee
Ie	Ie
Ye	Ye
Ees	Ế
Eets	Ết
Eeus	Ếu
Eeps	Ếp
Eechs	Ếch
Eens	Ến
Eems	Ếm
Iees	Iế
Ieets	Iết
Ieest	Iết
Ieens	Iến
Eengs	Ếng
Ieengs	Iếng
Ieems	Iếm
Ieecs	Iếc
Ieeus	Iếu
Ieeps	Iếp
Yees	Yế
Yeens	Yến
Yeengs	Yếng
Yeems	Yếm
Yeets	Yết
Yeest	Yết
Yeeus	Yếu
Uyees	Uyế
Uyeets	Uyết
Uyeens	Uyến
Ie	Ie
Eess	Ees
Eenss	Eens
Eetss	Eets
Eepss	Eeps
Eef	Ề
Eeuf	Ều
Eepf	Ềp
Eenf	Ền
Eenhf	Ềnh
Eemf	Ềm
Ieef	Iề
Ieenf	Iền
Ieengf	Iềng
Ieemf	Iềm
Ieecf	Iềc
Ieeuf	Iều
Ieepf	Iềp
Yeef	Yề
Yeenf	Yền
Yeengf	Yềng
Yeemf	Yềm
Yeetf	Yềt
Yeeuf	Yều
Uyeef	Uyề
Uyeetf	Uyềt
Uyeenf	Uyền
Eer	Ể
Eetr	Ểt
Eeur	Ểu
Eepr	Ểp
Eenr	Ển
Eenhr	Ểnh
Eemr	Ểm
Ieer	Iể
Ieenr	Iển
Ieengr	Iểng
Ieemr	Iểm
Ieecr	Iểc
Ieeur	Iểu
Ieepr	Iểp
Yeenr	Yển
Yeengr	Yểng
Yeemr	Yểm
Yeetr	Yểt
Yeeur	Yểu
Uyeetr	Uyểt
Uyeenr	Uyển
Uyeern	Uyển
Eerr	Eer
Eex	Ễ
Eetx	Ễt
Eeux	Ễu
Eepx	Ễp
Eenx	Ễn
Eemx	Ễm
Ieex	Iễ
Ieenx	Iễn
Ieengx	Iễng
Ieemx	Iễm
Ieecx	Iễc
Ieeux	Iễu
Ieepx	Iễp
Yeenx	Yễn
Yeengx	Yễng
Yeemx	Yễm
Yeetx	Yễt
Yeeux	Yễu
Uyeetx	Uyễt
Uyeenx	Uyễn
Uyeexn	Uyễn
Eej	Ệ
Eetj	Ệt
Eeuj	Ệu
Eepj	Ệp
Eenj	Ện
Eenhj	Ệnh
Eechj	Ệch
Eecjh	Ệch
Eemj	Ệm
Ieej	Iệ
Ieetj	Iệt
Ieejt	Iệt
Ieenj	Iện
Ieengj	Iệng
Ieemj	Iệm
Ieecj	Iệc
Ieeuj	Iệu
Ieepj	Iệp
Yeenj	Yện
Yeengj	Yệng
Yeemj	Yệm
Yeetj	Yệt
Yeeuj	Yệu
Uyeetj	Uyệt
Uyeenj	Uyện
Uyeejn	Uyện
Oi	Oi
Ooo	Oo
Oc	Oc
On	On
Ong	Ong
Om	Om
Ot	Ot
Op	Op
Os	Ó
Ots	Ót
Ois	Ói
Ooos	Oó
Ops	Óp
Ocs	Óc
Ons	Ón
Ongs	Óng
Oms	Óm
Oss	Os
Otss	Ots
Oiss	Ois
Opss	Ops
Onss	Ons
Omss	Oms
Of	Ò
Otf	Òt
Oif	Òi
Ooof	Oò
Opf	Òp
Ocf	Òc
Onf	Òn
Ongf	Òng
Omf	Òm
Off	Of
Otff	Otf
Opff	Opf
Onff	Onf
Omff	Omf
Or	Ỏ
Otr	Ỏt
Oir	Ỏi
Ooor	Oỏ
Opr	Ỏp
Ocr	Ỏc
Onr	Ỏn
Ongr	Ỏng
Omr	Ỏm
Orr	Or
Ox	Õ
Otx	Õt
Oix	Õi
Ooox	Oõ
Opx	Õp
Ocx	Õc
Onx	Õn
Ongx	Õng
Omx	Õm
Oxx	Ox
Oj	Ọ
Otj	Ọt
Oij	Ọi
Oooj	Oọ
Opj	Ọp
Ocj	Ọc
Onj	Ọn
Ongj	Ọng
Omj	Ọm
Oo	Ô
Ooc	Ôc
Oot	Ôt
Oop	Ôp
Oon	Ôn
Oong	Ông
Oom	Ôm
Ooi	Ôi
Uooi	Uôi
Uooc	Uôc
Uoot	Uôt
Uoon	Uôn
Uoong	Uông
Uoom	Uôm
Oos	Ố
Oocs	Ốc
Oots	Ốt
Oops	Ốp
Oons	Ốn
Oongs	Ống
Ooms	Ốm
Oois	Ối
Uoois	Uối
Uoosi	Uối
Uoocs	Uốc
Uoosc	Uốc
Uoots	Uốt
Uoons	Uốn
Uoongs	Uống
Uooms	Uốm
Ootss	Oots
Oof	Ồ
Oocf	Ồc
Ootf	Ồt
Oopf	Ồp
Oonf	Ồn
Oongf	Ồng
Oomf	Ồm
Ooif	Ồi
Uoocf	Uồc
Uootf	Uồt
Uoonf	Uồn
Uoongf	Uồng
Uoomf	Uồm
Oor	Ổ
Oocr	Ổc
Ootr	Ổt
Oopr	Ổp
Oonr	Ổn
Oongr	Ổng
Oomr	Ổm
Ooir	Ổi
Uooir	Uổi
Uoocr	Uổc
Uootr	Uổt
Uoonr	Uổn
Uoongr	Uổng
Uoomr	Uổm
Oox	Ỗ
Oocx	Ỗc
Ootx	Ỗt
Oopx	Ỗp
Oonx	Ỗn
Oongx	Ỗng
Oomx	Ỗm
Ooix	Ỗi
Uooix	Uỗi
Uoocx	Uỗc
Uootx	Uỗt
Uoonx	Uỗn
Uoongx	Uỗng
Uoomx	Uỗm
Ooj	Ộ
Oocj	Ộc
Ootj	Ột
Oopj	Ộp
Oonj	Ộn
Oongj	Ộng
Oomj	Ộm
Ooij	Ội
Uooij	Uội
Uooji	Uội
Uoocj	Uộc
Uoojc	Uộc
Uootj	Uột
Uoonj	Uộn
Uoongj	Uộng
Uoomj	Uộm
Ow	Ơ
Owt	Ơt
Owp	Ơp
Own	Ơn
Owm	Ơm
Owi	Ơi
Uowc	Ươc
Wowc	Ươc
Uwowc	Ươc
Uowi	Ươi
Wowi	Ươi
Uwowi	Ươi
Uowt	Ươt
Wowt	Ươt
Uwowt	Ươt
Uowp	Ươp
Wowp	Ươp
Uwowp	Ươp
Uown	Ươn
Wown	Ươn
Uwown	Ươn
Uowm	Ươm
Wowm	Ươm
Uwowm	Ươm
Uwowu	Ươu
Uowng	Ương
Wowng	Ương
Uwowng	Ương
Oww	Ow
Wo	Wo
Ows	Ớ
Owts	Ớt
Owps	Ớp
Owns	Ớn
Owms	Ớm
Owis	Ới
Uows	Ướ
Wows	Ướ
Uwows	Ướ
Uowcs	Ước
Wowcs	Ước
Uwowcs	Ước
Uowis	Ưới
Wowis	Ưới
Uwowis	Ưới
Uowts	Ướt
Wowts	Ướt
Uwowts	Ướt
Uowps	Ướp
Wowps	Ướp
Uwowps	Ướp
Uowns	Ướn
Wowns	Ướn
Uwowns	Ướn
Uowms	Ướm
Wowms	Ướm
Uwowms	Ướm
Uwowus	Ướu
Uowcs	Ướng
Wowngs	Ướng
Uwowngs	Ướng
Owss	Ows
Owf	Ờ
Owtf	Ờt
Owpf	Ờp
Ownf	Ờn
Owmf	Ờm
Owif	Ời
Uowf	Ườ
Wowf	Ườ
Uwowf	Ườ
Uowtf	Ườt
Wowtf	Ườt
Uwowtf	Ườt
Uowif	Ười
Wowif	Ười
Uwowif	Ười
Uowpf	Ườp
Wowpf	Ườp
Uwowpf	Ườp
Uownf	Ườn
Wownf	Ườn
Uwownf	Ườn
Uowmf	Ườm
Wowmf	Ườm
Uwowmf	Ườm
Uowngf	Ường
Wowngf	Ường
Uwowngf	Ường
Owff	Owf
Owr	Ở
Owtr	Ởt
Owpr	Ởp
Ownr	Ởn
Owmr	Ởm
Owir	Ởi
Uowr	Ưở
Wowr	Ưở
Uwowr	Ưở
Uowtr	Ưởt
Wowtr	Ưởt
Uwowtr	Ưởt
Uowir	Ưởi
Wowir	Ưởi
Uwowir	Ưởi
Uowpr	Ưởp
Wowpr	Ưởp
Uwowpr	Ưởp
Uownr	Ưởn
Wownr	Ưởn
Uwownr	Ưởn
Uowmr	Ưởm
Wowmr	Ưởm
Uwowmr	Ưởm
Uowngr	Ưởng
Wowngr	Ưởng
Uwowngr	Ưởng
Owrr	Owr
Owx	Ỡ
Owtx	Ỡt
Owpx	Ỡp
Ownx	Ỡn
Owmx	Ỡm
Owix	Ỡi
Uowx	Ưỡ
Wowx	Ưỡ
Uwowx	Ưỡ
Uowtx	Ưỡt
Wowtx	Ưỡt
Uwowtx	Ưỡt
Uowix	Ưỡi
Wowix	Ưỡi
Uwowix	Ưỡi
Uowpx	Ưỡp
Wowpx	Ưỡp
Uwowpx	Ưỡp
Uownx	Ưỡn
Wownx	Ưỡn
Uwownx	Ưỡn
Uowmx	Ưỡm
Wowmx	Ưỡm
Uwowmx	Ưỡm
Uowngx	Ưỡng
Wowngx	Ưỡng
Uwowngx	Ưỡng
Owxx	Owx
Owj	Ợ
Owtj	Ợt
Owpj	Ợp
Ownj	Ợn
Owmj	Ợm
Owij	Ợi
Uowj	Ượ
Wowj	Ượ
Uwowj	Ượ
Uowtj	Ượt
Wowtj	Ượt
Uwowtj	Ượt
Uowij	Ượi
Wowij	Ượi
Uwowij	Ượi
Uowpj	Ượp
Wowpj	Ượp
Uwowpj	Ượp
Uowcj	Ược
Wowcj	Ược
Uwowcj	Ược
Uownj	Ượn
Wownj	Ượn
Uwownj	Ượn
Uowmj	Ượm
Wowmj	Ượm
Uwowmj	Ượm
Uwowuj	Ượu
Uowngj	Ượng
Wowngj	Ượng
Uwowngj	Ượng
Owjj	Owj
Ui	Ui
Up	Up
Ut	Ut
Uy	Uy
Ua	Ua
Uc	Uc
Un	Un
Um	Um
Ung	Ung
Uo	Uo
Us	Ú
Uis	Úi
Ups	Úp
Uts	Út
Uas	Úa
Ucs	Úc
Uns	Ún
Ums	Úm
Ungs	Úng
Uss	Us
Uf	Ù
Uif	Ùi
Uaf	Ùa
Unf	Ùn
Umf	Ùm
Ungf	Ùng
Uff	Uf
Uiff	Uif
Uaff	Uaf
Unff	Unf
Umff	Umf
Ur	Ủ
Uir	Ủi
Uar	Ủa
Unr	Ủn
Umr	Ủm
Ungr	Ủng
Urr	Ur
Unrr	Unr
Umrr	Umr
Ux	Ũ
Uix	Ũi
Uax	Ũa
Unx	Ũn
Umx	Ũm
Ungx	Ũng
Uxx	Ux
Uaxx	Uax
Unxx	Unx
Umxx	Umx
Uj	Ụ
Uij	Ụi
Uaj	Ụa
Unj	Ụn
Umj	Ụm
Ungj	Ụng
Utj	Ụt
Ucj	Ục
Upj	Ụp
Ujj	Uj
Unjj	Unj
Umjj	Umj
Uw	Ư
Uwi	Ưi
Uwa	Ưa
Uwn	Ưn
Uwng	Ưng
Uwc	Ưc
Uwu	Ưu
Uww	Uw
Uws	Ứ
Uwas	Ứa
Uwngs	Ứng
Uwts	Ứt
Uwcs	Ức
Uwus	Ứu
Uwf	Ừ
Uwaf	Ừa
Uwngf	Ừng
Uwuf	Ừu
Uwr	Ử
Uwir	Ửi
Uwar	Ửa
Uwngr	Ửng
Uwur	Ửu
Uwx	Ữ
Uwax	Ữa
Uwnx	Ữn
Uwngx	Ững
Uwux	Ữu
Uwj	Ự
Uwaj	Ựa
Uwngj	Ựng
Uwuj	Ựu
Uwcj	Ực
Gi	Gi
Ia	Ia
It	It
Ip	Ip
Ic	Ic
In	In
Iu	Iu
Im	Im
Inh	Inh
Ich	Ich
Is	Í
Ias	Ía
Ics	Íc
Its	Ít
Ips	Íp
Ichs	Ích
Ins	Ín
Ius	Íu
Ims	Ím
Inhs	Ính
Iss	Is
Iass	Ias
Icss	Ics
Itss	Its
Inss	Ins
Ipss	Ips
If	Ì
Iaf	Ìa
Inf	Ìn
Imf	Ìm
Inhf	Ình
Iuf	Ìu
Gif	Gì
Iff	If
Iaff	Iaf
Inff	Inf
Imff	Imf
Iuff	Iuf
Giff	Gif
Ir	Ỉ
Iar	Ỉa
Inr	Ỉn
Imr	Ỉm
Inhr	Ỉnh
Iur	Ỉu
Gir	Gỉ
Irr	Ir
Iarr	Iar
Inrr	Inr
Imrr	Imr
Inhrr	Inhr
Iurr	Iur
Girr	Gir
Ix	Ĩ
Iax	Ĩa
Inx	Ĩn
Imx	Ĩm
Inhx	Ĩnh
Iux	Ĩu
Ixx	Ix
Iaxx	Iax
Inxx	Inx
Imxx	Imx
Inhxx	Inhx
Iuxx	Iux
Ij	Ị
Iaj	Ịa
Inj	Ịn
Imj	Ịm
Ipj	Ịp
Inhj	Ịnh
Itj	Ịt
Ichj	Ịch
Icjh	Ịch
Iuj	Ịu
Icjj	Icj
Injj	Inj
Ipjj	Ipj
Itjj	Itj
Ichjj	Ichj
Iujj	Iuj
Uy	Uy
Uynh	Uynh
Uyt	Uyt
Uych	Uych
Ys	Ý
Ynhs	Ýnh
Uys	Uý
Uynhs	Uýnh
Uyts	Uýt
Uychs	Uých
Yss	Ys
Yf	Ỳ
Ynhf	Ỳnh
Uyf	Uỳ
Uynhf	Uỳnh
Uychf	Uỳch
Yr	Ỷ
Uyr	Uỷ
Uychr	Uỷch
Yx	Ỹ
Uyx	Uỹ
Yj	Ỵ
Uyj	Uỵ
Uytj	Uỵt
Uychj	Uỵch
Dd	Đ
Ddd	Dd
Qu	Qu
ac	ac
au	au
ai	ai
ao	ao
oa	oa
an	an
anh	anh
ang	ang
am	am
ap	ap
at	at
ay	ay
oac	oac
oach	oach
oai	oai
oat	oat
oan	oan
oanh	oanh
oang	oang
as	á
acs	ác
achs	ách
ats	át
aps	áp
aus	áu
ais	ái
aos	áo
oas	oá
ans	án
anhs	ánh
angs	áng
ams	ám
ays	áy
oacs	oác
oachs	oách
oais	oái
oats	oát
oans	oán
oanhs	oánh
oangs	oáng
oass	oas
ass	as
auss	aus
apss	aps
amss	ams
anss	ans
oacss	oacs
achss	achs
apss	aps
af	à
acf	àc
achf	àch
atf	àt
apf	àp
auf	àu
aif	ài
aof	ào
oaf	oà
anf	àn
anhf	ành
angf	àng
amf	àm
ay	ay
ayf	ày
oacf	oàc
oachf	oàch
oaif	oài
oatf	oàt
oanf	oàn
oanhf	oành
oangf	oàng
aff	af
ar	ả
acr	ảc
achr	ảch
atr	ảt
apr	ảp
aur	ảu
air	ải
aor	ảo
oar	oả
anr	ản
anhr	ảnh
angr	ảng
amr	ảm
ayr	ảy
oacr	oảc
oachr	oảch
oair	oải
oatr	oảt
oanr	oản
oanhr	oảnh
oangr	oảng
arr	ar
acrr	acr
atrr	atr
aurr	aur
ax	ã
acx	ãc
achx	ãch
atx	ãt
apx	ãp
aux	ãu
aix	ãi
aox	ão
oax	oã
anx	ãn
anhx	ãnh
angx	ãng
amx	ãm
ayx	ãy
oacx	oãc
oachx	oãch
oaix	oãi
oatx	oãt
oanx	oãn
oanhx	oãnh
oangx	oãng
axx	ax
auxx	aux
aixx	aix
atxx	atx
aj	ạ
acj	ạc
achj	ạch
atj	ạt
apj	ạp
auj	ạu
aij	ại
aoj	ạo
oaj	oạ
anj	ạn
anhj	ạnh
angj	ạng
amj	ạm
ayj	ạy
oacj	oạc
oachj	oạch
oaij	oại
oatj	oạt
oanj	oạn
oangj	oạnh
oanhj	oạng
ajj	aj
acjj	acj
aa	â
aam	âm
aau	âu
aan	ân
aay	ây
aang	âng
uaat	uât
uaan	uân
uaang	uâng
aaa	aa
aas	ấ
aacs	ấc
aats	ất
aaps	ấp
aaus	ấu
aans	ấn
aangs	ấng
aams	ấm
aays	ấy
uaats	uất
uaans	uấn
uaangs	uấng
aaf	ầ
aacf	ầc
aatf	ầt
aapf	ầp
aauf	ầu
aanf	ần
aangf	ầng
aamf	ầm
aayf	ầy
uaatf	uầt
uaanf	uần
uaangf	uầng
aar	ẩ
aacr	ẩc
aatr	ẩt
aapr	ẩp
aaur	ẩu
aanr	ẩn
aangr	ẩng
aamr	ẩm
aayr	ẩy
uaatr	uẩt
uaanr	uẩn
uaangr	uẩng
aax	ẫ
aacx	ẫc
aatx	ẫt
aapx	ẫp
aaux	ẫu
aanx	ẫn
aangx	ẫng
aamx	ẫm
aayx	ẫy
uaatx	uẫt
uaanx	uẫn
uaangx	uẫng
aaj	ậ
aacj	ậc
aatj	ật
aapj	ập
aauj	ậu
aanj	ận
aangj	ậng
aamj	ậm
aayj	ậy
uaatj	uật
uaanj	uận
uaangj	uậng
aw	ă
awn	ăn
awng	ăng
awm	ăm
oawn	oăn
oawt	oăt
aww	aw
aws	ắ
awcs	ắc
awts	ắt
awps	ắp
awns	ắn
awngs	ắng
awms	ắm
oaws	oắ
oawns	oắn
oawts	oắt
oawcs	oắc
awf	ằ
awcf	ằc
awtf	ằt
awpf	ằp
awnf	ằn
awngf	ằng
awmf	ằm
oawf	oằ
oawnf	oằn
oawtf	oằt
awr	ẳ
awcr	ẳc
awtr	ẳt
awpr	ẳp
awnr	ẳn
awngr	ẳng
awmr	ẳm
oawr	oẳ
oawnr	oẳn
oawtr	oẳt
awx	ẵ
awcx	ẵc
awtx	ẵt
awpx	ẵp
awnx	ẵn
awngx	ẵng
awmx	ẵm
oawx	oẵ
oawnx	oẵn
oawtx	oẵt
awj	ặ
awcj	ặc
awtj	ặt
awpj	ặp
awnj	ặn
awngj	ặng
awmj	ặm
oawj	oặ
oawnj	oặn
oawtj	oặt
oawcj	oặc
eo	eo
oe	oe
en	en
em	em
et	et
ec	ec
ep	ep
es	é
ecs	éc
ets	ét
eps	ép
eos	éo
oes	oé
oets	oét
ens	én
ems	ém
ess	es
ecss	ecs
etss	ets
epss	eps
enss	ens
emss	ems
ef	è
ecf	èc
etf	èt
epf	èp
eof	èo
oef	oè
enf	èn
emf	èm
eff	ef
ecff	ecf
etff	etf
oeff	oef
er	ẻ
ecr	ẻc
etr	ẻt
epr	ẻp
eor	ẻo
oer	oẻ
enr	ẻn
emr	ẻm
err	er
ecrr	ecr
etrr	etr
oerr	oer
ex	ẽ
ecx	ẽc
etx	ẽt
epx	ẽp
eox	ẽo
oex	oẽ
enx	ẽn
emx	ẽm
exx	ex
ej	ẹ
ecj	ẹc
etj	ẹt
epj	ẹp
eoj	ẹo
oej	oẹ
enj	ẹn
emj	ẹm
ejj	ej
ee	ê
eeu	êu
een	ên
eenh	ênh
eem	êm
ieen	iên
ieeng	iêng
ieem	iêm
ieec	iêc
ieeu	iêu
ieep	iêp
yeen	yên
yeeng	yêng
yeem	yêm
yeet	yêt
yeeu	yêu
uyeet	uyêt
uyeen	uyên
eee	ee
ie	ie
ye	ye
ees	ế
eets	ết
eeus	ếu
eeps	ếp
eechs	ếch
eens	ến
eems	ếm
iees	iế
ieets	iết
ieest	iết
ieens	iến
eengs	ếng
ieengs	iếng
ieems	iếm
ieecs	iếc
ieeus	iếu
ieeps	iếp
yees	yế
yeens	yến
yeengs	yếng
yeems	yếm
yeets	yết
yeest	yết
yeeus	yếu
uyees	uyế
uyeets	uyết
uyeens	uyến
ie	ie
eess	ees
eenss	eens
eetss	eets
eepss	eeps
eef	ề
eeuf	ều
eepf	ềp
eenf	ền
eenhf	ềnh
eemf	ềm
ieef	iề
ieenf	iền
ieengf	iềng
ieemf	iềm
ieecf	iềc
ieeuf	iều
ieepf	iềp
yeef	yề
yeenf	yền
yeengf	yềng
yeemf	yềm
yeetf	yềt
yeeuf	yều
uyeef	uyề
uyeetf	uyềt
uyeenf	uyền
eer	ể
eetr	ểt
eeur	ểu
eepr	ểp
eenr	ển
eenhr	ểnh
eemr	ểm
ieer	iể
ieenr	iển
ieengr	iểng
ieemr	iểm
ieecr	iểc
ieeur	iểu
ieepr	iểp
yeenr	yển
yeengr	yểng
yeemr	yểm
yeetr	yểt
yeeur	yểu
uyeetr	uyểt
uyeenr	uyển
uyeern	uyển
eerr	eer
eex	ễ
eetx	ễt
eeux	ễu
eepx	ễp
eenx	ễn
eemx	ễm
ieex	iễ
ieenx	iễn
ieengx	iễng
ieemx	iễm
ieecx	iễc
ieeux	iễu
ieepx	iễp
yeenx	yễn
yeengx	yễng
yeemx	yễm
yeetx	yễt
yeeux	yễu
uyeetx	uyễt
uyeenx	uyễn
uyeexn	uyễn
eej	ệ
eetj	ệt
eeuj	ệu
eepj	ệp
eenj	ện
eenhj	ệnh
eechj	ệch
eecjh	ệch
eemj	ệm
ieej	iệ
ieetj	iệt
ieejt	iệt
ieenj	iện
ieengj	iệng
ieemj	iệm
ieecj	iệc
ieeuj	iệu
ieepj	iệp
yeenj	yện
yeengj	yệng
yeemj	yệm
yeetj	yệt
yeeuj	yệu
uyeetj	uyệt
uyeenj	uyện
uyeejn	uyện
oi	oi
ooo	oo
oc	oc
on	on
ong	ong
om	om
ot	ot
op	op
os	ó
ots	ót
ois	ói
ooos	oó
ops	óp
ocs	óc
ons	ón
ongs	óng
oms	óm
oss	os
otss	ots
oiss	ois
opss	ops
onss	ons
omss	oms
of	ò
otf	òt
oif	òi
ooof	oò
opf	òp
ocf	òc
onf	òn
ongf	òng
omf	òm
off	of
otff	otf
opff	opf
onff	onf
omff	omf
or	ỏ
otr	ỏt
oir	ỏi
ooor	oỏ
opr	ỏp
ocr	ỏc
onr	ỏn
ongr	ỏng
omr	ỏm
orr	or
ox	õ
otx	õt
oix	õi
ooox	oõ
opx	õp
ocx	õc
onx	õn
ongx	õng
omx	õm
oxx	ox
oj	ọ
otj	ọt
oij	ọi
oooj	oọ
opj	ọp
ocj	ọc
onj	ọn
ongj	ọng
omj	ọm
oo	ô
ooc	ôc
oot	ôt
oop	ôp
oon	ôn
oong	ông
oom	ôm
ooi	ôi
uooi	uôi
uooc	uôc
uoot	uôt
uoon	uôn
uoong	uông
uoom	uôm
oos	ố
oocs	ốc
oots	ốt
oops	ốp
oons	ốn
oongs	ống
ooms	ốm
oois	ối
uoois	uối
uoosi	uối
uoocs	uốc
uoosc	uốc
uoots	uốt
uoons	uốn
uoongs	uống
uooms	uốm
ootss	oots
oof	ồ
oocf	ồc
ootf	ồt
oopf	ồp
oonf	ồn
oongf	ồng
oomf	ồm
ooif	ồi
uoocf	uồc
uootf	uồt
uoonf	uồn
uoongf	uồng
uoomf	uồm
oor	ổ
oocr	ổc
ootr	ổt
oopr	ổp
oonr	ổn
oongr	ổng
oomr	ổm
ooir	ổi
uooir	uổi
uoocr	uổc
uootr	uổt
uoonr	uổn
uoongr	uổng
uoomr	uổm
oox	ỗ
oocx	ỗc
ootx	ỗt
oopx	ỗp
oonx	ỗn
oongx	ỗng
oomx	ỗm
ooix	ỗi
uooix	uỗi
uoocx	uỗc
uootx	uỗt
uoonx	uỗn
uoongx	uỗng
uoomx	uỗm
ooj	ộ
oocj	ộc
ootj	ột
oopj	ộp
oonj	ộn
oongj	ộng
oomj	ộm
ooij	ội
uooij	uội
uooji	uội
uoocj	uộc
uoojc	uộc
uootj	uột
uoonj	uộn
uoongj	uộng
uoomj	uộm
ow	ơ
owt	ơt
owp	ơp
own	ơn
owm	ơm
owi	ơi
uowc	ươc
wowc	ươc
uwowc	ươc
uowi	ươi
wowi	ươi
uwowi	ươi
uowt	ươt
wowt	ươt
uwowt	ươt
uowp	ươp
wowp	ươp
uwowp	ươp
uown	ươn
wown	ươn
uwown	ươn
uowm	ươm
wowm	ươm
uwowm	ươm
uwowu	ươu
uowng	ương
wowng	ương
uwowng	ương
oww	ow
wo	wo
ows	ớ
owts	ớt
owps	ớp
owns	ớn
owms	ớm
owis	ới
uows	ướ
wows	ướ
uwows	ướ
uowcs	ước
wowcs	ước
uwowcs	ước
uowis	ưới
wowis	ưới
uwowis	ưới
uowts	ướt
wowts	ướt
uwowts	ướt
uowps	ướp
wowps	ướp
uwowps	ướp
uowns	ướn
wowns	ướn
uwowns	ướn
uowms	ướm
wowms	ướm
uwowms	ướm
uwowus	ướu
uowcs	ướng
wowngs	ướng
uwowngs	ướng
owss	ows
owf	ờ
owtf	ờt
owpf	ờp
ownf	ờn
owmf	ờm
owif	ời
uowf	ườ
wowf	ườ
uwowf	ườ
uowtf	ườt
wowtf	ườt
uwowtf	ườt
uowif	ười
wowif	ười
uwowif	ười
uowpf	ườp
wowpf	ườp
uwowpf	ườp
uownf	ườn
wownf	ườn
uwownf	ườn
uowmf	ườm
wowmf	ườm
uwowmf	ườm
uowngf	ường
wowngf	ường
uwowngf	ường
owff	owf
owr	ở
owtr	ởt
owpr	ởp
ownr	ởn
owmr	ởm
owir	ởi
uowr	ưở
wowr	ưở
uwowr	ưở
uowtr	ưởt
wowtr	ưởt
uwowtr	ưởt
uowir	ưởi
wowir	ưởi
uwowir	ưởi
uowpr	ưởp
wowpr	ưởp
uwowpr	ưởp
uownr	ưởn
wownr	ưởn
uwownr	ưởn
uowmr	ưởm
wowmr	ưởm
uwowmr	ưởm
uowngr	ưởng
wowngr	ưởng
uwowngr	ưởng
owrr	owr
owx	ỡ
owtx	ỡt
owpx	ỡp
ownx	ỡn
owmx	ỡm
owix	ỡi
uowx	ưỡ
wowx	ưỡ
uwowx	ưỡ
uowtx	ưỡt
wowtx	ưỡt
uwowtx	ưỡt
uowix	ưỡi
wowix	ưỡi
uwowix	ưỡi
uowpx	ưỡp
wowpx	ưỡp
uwowpx	ưỡp
uownx	ưỡn
wownx	ưỡn
uwownx	ưỡn
uowmx	ưỡm
wowmx	ưỡm
uwowmx	ưỡm
uowngx	ưỡng
wowngx	ưỡng
uwowngx	ưỡng
owxx	owx
owj	ợ
owtj	ợt
owpj	ợp
ownj	ợn
owmj	ợm
owij	ợi
uowj	ượ
wowj	ượ
uwowj	ượ
uowtj	ượt
wowtj	ượt
uwowtj	ượt
uowij	ượi
wowij	ượi
uwowij	ượi
uowpj	ượp
wowpj	ượp
uwowpj	ượp
uowcj	ược
wowcj	ược
uwowcj	ược
uownj	ượn
wownj	ượn
uwownj	ượn
uowmj	ượm
wowmj	ượm
uwowmj	ượm
uwowuj	ượu
uowngj	ượng
wowngj	ượng
uwowngj	ượng
owjj	owj
ui	ui
up	up
ut	ut
uy	uy
ua	ua
uc	uc
un	un
um	um
ung	ung
uo	uo
us	ú
uis	úi
ups	úp
uts	út
uas	úa
ucs	úc
uns	ún
ums	úm
ungs	úng
uss	us
uf	ù
uif	ùi
uaf	ùa
unf	ùn
umf	ùm
ungf	ùng
uff	uf
uiff	uif
uaff	uaf
unff	unf
umff	umf
ur	ủ
uir	ủi
uar	ủa
unr	ủn
umr	ủm
ungr	ủng
urr	ur
unrr	unr
umrr	umr
ux	ũ
uix	ũi
uax	ũa
unx	ũn
umx	ũm
ungx	ũng
uxx	ux
uaxx	uax
unxx	unx
umxx	umx
uj	ụ
uij	ụi
uaj	ụa
unj	ụn
umj	ụm
ungj	ụng
utj	ụt
ucj	ục
upj	ụp
ujj	uj
unjj	unj
umjj	umj
uw	ư
uwi	ưi
uwa	ưa
uwn	ưn
uwng	ưng
uwc	ưc
uwu	ưu
uww	uw
uws	ứ
uwas	ứa
uwngs	ứng
uwts	ứt
uwcs	ức
uwus	ứu
uwf	ừ
uwaf	ừa
uwngf	ừng
uwuf	ừu
uwr	ử
uwir	ửi
uwar	ửa
uwngr	ửng
uwur	ửu
uwx	ữ
uwax	ữa
uwnx	ữn
uwngx	ững
uwux	ữu
uwj	ự
uwaj	ựa
uwngj	ựng
uwuj	ựu
uwcj	ực
gi	gi
ia	ia
it	it
ip	ip
ic	ic
in	in
iu	iu
im	im
inh	inh
ich	ich
is	í
ias	ía
ics	íc
its	ít
ips	íp
ichs	ích
ins	ín
ius	íu
ims	ím
inhs	ính
iss	is
iass	ias
icss	ics
itss	its
inss	ins
ipss	ips
if	ì
iaf	ìa
inf	ìn
imf	ìm
inhf	ình
iuf	ìu
gif	gì
iff	if
iaff	iaf
inff	inf
imff	imf
iuff	iuf
giff	gif
ir	ỉ
iar	ỉa
inr	ỉn
imr	ỉm
inhr	ỉnh
iur	ỉu
gir	gỉ
irr	ir
iarr	iar
inrr	inr
imrr	imr
inhrr	inhr
iurr	iur
girr	gir
ix	ĩ
iax	ĩa
inx	ĩn
imx	ĩm
inhx	ĩnh
iux	ĩu
ixx	ix
iaxx	iax
inxx	inx
imxx	imx
inhxx	inhx
iuxx	iux
ij	ị
iaj	ịa
inj	ịn
imj	ịm
ipj	ịp
inhj	ịnh
itj	ịt
ichj	ịch
icjh	ịch
iuj	ịu
icjj	icj
injj	inj
ipjj	ipj
itjj	itj
ichjj	ichj
iujj	iuj
uy	uy
uynh	uynh
uyt	uyt
uych	uych
ys	ý
ynhs	ýnh
uys	uý
uynhs	uýnh
uyts	uýt
uychs	uých
yss	ys
yf	ỳ
ynhf	ỳnh
uyf	uỳ
uynhf	uỳnh
uychf	uỳch
yr	ỷ
uyr	uỷ
uychr	uỷch
yx	ỹ
uyx	uỹ
yj	ỵ
uyj	uỵ
uytj	uỵt
uychj	uỵch
dd	đ
ddd	dd
qu	qu
a	a
e	e
i	i
o	o
u	u
y	y
A	A
E	E
I	I
O	O
U	U
Y	Y
d	d
D	D
g	g
G	G
q	q
Q	Q
w	w
W	W
