a	a
A	A
aac	âc
Aac	Âc
AaC	ÂC
AAc	Âc
AAC	ÂC
aacj	ậc
aacJ	ậc
Aacj	Ậc
AaCj	ẬC
AAcJ	Ậc
AACJ	ẬC
aacs	ấc
aacS	ấc
Aacs	Ấc
AaCs	ẤC
AAcS	Ấc
AACS	ẤC
aafm	ầm
aaFm	ầm
Aafm	Ầm
AafM	ẦM
AAFm	Ầm
AAFM	ẦM
aafn	ần
aaFn	ần
Aafn	Ần
AafN	ẦN
AAFn	Ần
AAFN	ẦN
aafng	ầng
aaFng	ầng
Aafng	Ầng
AafNG	ẦNG
AAFng	Ầng
AAFNG	ẦNG
aafu	ầu
aaFu	ầu
Aafu	Ầu
AafU	ẦU
AAFu	Ầu
AAFU	ẦU
aafy	ầy
aaFy	ầy
Aafy	Ầy
AafY	ẦY
AAFy	Ầy
AAFY	ẦY
aajc	ậc
aaJc	ậc
Aajc	Ậc
AajC	ẬC
AAJc	Ậc
AAJC	ẬC
aajm	ậm
aaJm	ậm
Aajm	Ậm
AajM	ẬM
AAJm	Ậm
AAJM	ẬM
aajn	ận
aaJn	ận
Aajn	Ận
AajN	ẬN
AAJn	Ận
AAJN	ẬN
aajng	ậng
aaJng	ậng
Aajng	Ậng
AajNG	ẬNG
AAJng	Ậng
AAJNG	ẬNG
aajp	ập
aaJp	ập
Aajp	Ập
AajP	ẬP
AAJp	Ập
AAJP	ẬP
aajt	ật
aaJt	ật
Aajt	Ật
AajT	ẬT
AAJt	Ật
AAJT	ẬT
aaju	ậu
aaJu	ậu
Aaju	Ậu
AajU	ẬU
AAJu	Ậu
AAJU	ẬU
aajy	ậy
aaJy	ậy
Aajy	Ậy
AajY	ẬY
AAJy	Ậy
AAJY	ẬY
aam	âm
Aam	Âm
AaM	ÂM
AAm	Âm
AAM	ÂM
aamf	ầm
aamF	ầm
Aamf	Ầm
AaMf	ẦM
AAmF	Ầm
AAMF	ẦM
aamj	ậm
aamJ	ậm
Aamj	Ậm
AaMj	ẬM
AAmJ	Ậm
AAMJ	ẬM
aamr	ẩm
aamR	ẩm
Aamr	Ẩm
AaMr	ẨM
AAmR	Ẩm
AAMR	ẨM
aams	ấm
aamS	ấm
Aams	Ấm
AaMs	ẤM
AAmS	Ấm
AAMS	ẤM
aamx	ẫm
aamX	ẫm
Aamx	Ẫm
AaMx	ẪM
AAmX	Ẫm
AAMX	ẪM
aan	ân
Aan	Ân
AaN	ÂN
AAn	Ân
AAN	ÂN
aanf	ần
aanF	ần
Aanf	Ần
AaNf	ẦN
AAnF	Ần
AANF	ẦN
aang	âng
Aang	Âng
AaNG	ÂNG
AAng	Âng
AANG	ÂNG
aangf	ầng
aangF	ầng
Aangf	Ầng
AaNGf	ẦNG
AAngF	Ầng
AANGF	ẦNG
aangj	ậng
aangJ	ậng
Aangj	Ậng
AaNGj	ẬNG
AAngJ	Ậng
AANGJ	ẬNG
aangr	ẩng
aangR	ẩng
Aangr	Ẩng
AaNGr	ẨNG
AAngR	Ẩng
AANGR	ẨNG
aangs	ấng
aangS	ấng
Aangs	Ấng
AaNGs	ẤNG
AAngS	Ấng
AANGS	ẤNG
aangx	ẫng
aangX	ẫng
Aangx	Ẫng
AaNGx	ẪNG
AAngX	Ẫng
AANGX	ẪNG
aanj	ận
aanJ	ận
Aanj	Ận
AaNj	ẬN
AAnJ	Ận
AANJ	ẬN
aanr	ẩn
aanR	ẩn
Aanr	Ẩn
AaNr	ẨN
AAnR	Ẩn
AANR	ẨN
aans	ấn
aanS	ấn
Aans	Ấn
AaNs	ẤN
AAnS	Ấn
AANS	ẤN
aanx	ẫn
aanX	ẫn
Aanx	Ẫn
AaNx	ẪN
AAnX	Ẫn
AANX	ẪN
aap	âp
Aap	Âp
AaP	ÂP
AAp	Âp
AAP	ÂP
aapj	ập
aapJ	ập
Aapj	Ập
AaPj	ẬP
AApJ	Ập
AAPJ	ẬP
aaps	ấp
aapS	ấp
Aaps	Ấp
AaPs	ẤP
AApS	Ấp
AAPS	ẤP
aarm	ẩm
aaRm	ẩm
Aarm	Ẩm
AarM	ẨM
AARm	Ẩm
AARM	ẨM
aarn	ẩn
aaRn	ẩn
Aarn	Ẩn
AarN	ẨN
AARn	Ẩn
AARN	ẨN
aarng	ẩng
aaRng	ẩng
Aarng	Ẩng
AarNG	ẨNG
AARng	Ẩng
AARNG	ẨNG
aaru	ẩu
aaRu	ẩu
Aaru	Ẩu
AarU	ẨU
AARu	Ẩu
AARU	ẨU
aary	ẩy
aaRy	ẩy
Aary	Ẩy
AarY	ẨY
AARy	Ẩy
AARY	ẨY
aasc	ấc
aaSc	ấc
Aasc	Ấc
AasC	ẤC
AASc	Ấc
AASC	ẤC
aasm	ấm
aaSm	ấm
Aasm	Ấm
AasM	ẤM
AASm	Ấm
AASM	ẤM
aasn	ấn
aaSn	ấn
Aasn	Ấn
AasN	ẤN
AASn	Ấn
AASN	ẤN
aasng	ấng
aaSng	ấng
Aasng	Ấng
AasNG	ẤNG
AASng	Ấng
AASNG	ẤNG
aasp	ấp
aaSp	ấp
Aasp	Ấp
AasP	ẤP
AASp	Ấp
AASP	ẤP
aast	ất
aaSt	ất
Aast	Ất
AasT	ẤT
AASt	Ất
AAST	ẤT
aasu	ấu
aaSu	ấu
Aasu	Ấu
AasU	ẤU
AASu	Ấu
AASU	ẤU
aasy	ấy
aaSy	ấy
Aasy	Ấy
AasY	ẤY
AASy	Ấy
AASY	ẤY
aat	ât
Aat	Ât
AaT	ÂT
AAt	Ât
AAT	ÂT
aatj	ật
aatJ	ật
Aatj	Ật
AaTj	ẬT
AAtJ	Ật
AATJ	ẬT
aats	ất
aatS	ất
Aats	Ất
AaTs	ẤT
AAtS	Ất
AATS	ẤT
aau	âu
Aau	Âu
AaU	ÂU
AAu	Âu
AAU	ÂU
aauf	ầu
aauF	ầu
Aauf	Ầu
AaUf	ẦU
AAuF	Ầu
AAUF	ẦU
aauj	ậu
aauJ	ậu
Aauj	Ậu
AaUj	ẬU
AAuJ	Ậu
AAUJ	ẬU
aaur	ẩu
aauR	ẩu
Aaur	Ẩu
AaUr	ẨU
AAuR	Ẩu
AAUR	ẨU
aaus	ấu
aauS	ấu
Aaus	Ấu
AaUs	ẤU
AAuS	Ấu
AAUS	ẤU
aaux	ẫu
aauX	ẫu
Aaux	Ẫu
AaUx	ẪU
AAuX	Ẫu
AAUX	ẪU
aaxm	ẫm
aaXm	ẫm
Aaxm	Ẫm
AaxM	ẪM
AAXm	Ẫm
AAXM	ẪM
aaxn	ẫn
aaXn	ẫn
Aaxn	Ẫn
AaxN	ẪN
AAXn	Ẫn
AAXN	ẪN
aaxng	ẫng
aaXng	ẫng
Aaxng	Ẫng
AaxNG	ẪNG
AAXng	Ẫng
AAXNG	ẪNG
aaxu	ẫu
aaXu	ẫu
Aaxu	Ẫu
AaxU	ẪU
AAXu	Ẫu
AAXU	ẪU
aaxy	ẫy
aaXy	ẫy
Aaxy	Ẫy
AaxY	ẪY
AAXy	Ẫy
AAXY	ẪY
aay	ây
Aay	Ây
AaY	ÂY
AAy	Ây
AAY	ÂY
aayf	ầy
aayF	ầy
Aayf	Ầy
AaYf	ẦY
AAyF	Ầy
AAYF	ẦY
aayj	ậy
aayJ	ậy
Aayj	Ậy
AaYj	ẬY
AAyJ	Ậy
AAYJ	ẬY
aayr	ẩy
aayR	ẩy
Aayr	Ẩy
AaYr	ẨY
AAyR	Ẩy
AAYR	ẨY
aays	ấy
aayS	ấy
Aays	Ấy
AaYs	ẤY
AAyS	Ấy
AAYS	ẤY
aayx	ẫy
aayX	ẫy
Aayx	Ẫy
AaYx	ẪY
AAyX	Ẫy
AAYX	ẪY
ac	ac
Ac	Ac
AC	AC
ach	ach
Ach	Ach
ACH	ACH
achj	ạch
achJ	ạch
Achj	Ạch
AchJ	Ạch
ACHj	ẠCH
ACHJ	ẠCH
achs	ách
achS	ách
Achs	Ách
AchS	Ách
ACHs	ÁCH
ACHS	ÁCH
acj	ạc
acJ	ạc
Acj	Ạc
AcJ	Ạc
ACj	ẠC
ACJ	ẠC
acs	ác
acS	ác
Acs	Ác
AcS	Ác
ACs	ÁC
ACS	ÁC
af	à
aF	à
Af	À
AF	À
afi	ài
aFi	ài
Afi	Ài
AfI	ÀI
AFi	Ài
AFI	ÀI
afm	àm
aFm	àm
Afm	Àm
AfM	ÀM
AFm	Àm
AFM	ÀM
afn	àn
aFn	àn
Afn	Àn
AfN	ÀN
AFn	Àn
AFN	ÀN
afng	àng
aFng	àng
Afng	Àng
AfNG	ÀNG
AFng	Àng
AFNG	ÀNG
afnh	ành
aFnh	ành
Afnh	Ành
AfNH	ÀNH
AFnh	Ành
AFNH	ÀNH
afo	ào
aFo	ào
Afo	Ào
AfO	ÀO
AFo	Ào
AFO	ÀO
afu	àu
aFu	àu
Afu	Àu
AfU	ÀU
AFu	Àu
AFU	ÀU
afy	ày
aFy	ày
Afy	Ày
AfY	ÀY
AFy	Ày
AFY	ÀY
ai	ai
Ai	Ai
AI	AI
aif	ài
aiF	ài
Aif	Ài
AiF	Ài
AIf	ÀI
AIF	ÀI
aij	ại
aiJ	ại
Aij	Ại
AiJ	Ại
AIj	ẠI
AIJ	ẠI
air	ải
aiR	ải
Air	Ải
AiR	Ải
AIr	ẢI
AIR	ẢI
ais	ái
aiS	ái
Ais	Ái
AiS	Ái
AIs	ÁI
AIS	ÁI
aix	ãi
aiX	ãi
Aix	Ãi
AiX	Ãi
AIx	ÃI
AIX	ÃI
aj	ạ
aJ	ạ
Aj	Ạ
AJ	Ạ
ajc	ạc
aJc	ạc
Ajc	Ạc
AjC	ẠC
AJc	Ạc
AJC	ẠC
ajch	ạch
aJch	ạch
Ajch	Ạch
AjCH	ẠCH
AJch	Ạch
AJCH	ẠCH
aji	ại
aJi	ại
Aji	Ại
AjI	ẠI
AJi	Ại
AJI	ẠI
ajm	ạm
aJm	ạm
Ajm	Ạm
AjM	ẠM
AJm	Ạm
AJM	ẠM
ajn	ạn
aJn	ạn
Ajn	Ạn
AjN	ẠN
AJn	Ạn
AJN	ẠN
ajng	ạng
aJng	ạng
Ajng	Ạng
AjNG	ẠNG
AJng	Ạng
AJNG	ẠNG
ajnh	ạnh
aJnh	ạnh
Ajnh	Ạnh
AjNH	ẠNH
AJnh	Ạnh
AJNH	ẠNH
ajo	ạo
aJo	ạo
Ajo	Ạo
AjO	ẠO
AJo	Ạo
AJO	ẠO
ajp	ạp
aJp	ạp
Ajp	Ạp
AjP	ẠP
AJp	Ạp
AJP	ẠP
ajt	ạt
aJt	ạt
Ajt	Ạt
AjT	ẠT
AJt	Ạt
AJT	ẠT
aju	ạu
aJu	ạu
Aju	Ạu
AjU	ẠU
AJu	Ạu
AJU	ẠU
ajy	ạy
aJy	ạy
Ajy	Ạy
AjY	ẠY
AJy	Ạy
AJY	ẠY
am	am
Am	Am
AM	AM
amf	àm
amF	àm
Amf	Àm
AmF	Àm
AMf	ÀM
AMF	ÀM
amj	ạm
amJ	ạm
Amj	Ạm
AmJ	Ạm
AMj	ẠM
AMJ	ẠM
amr	ảm
amR	ảm
Amr	Ảm
AmR	Ảm
AMr	ẢM
AMR	ẢM
ams	ám
amS	ám
Ams	Ám
AmS	Ám
AMs	ÁM
AMS	ÁM
amx	ãm
amX	ãm
Amx	Ãm
AmX	Ãm
AMx	ÃM
AMX	ÃM
an	an
An	An
AN	AN
anf	àn
anF	àn
Anf	Àn
AnF	Àn
ANf	ÀN
ANF	ÀN
ang	ang
Ang	Ang
ANG	ANG
angf	àng
angF	àng
Angf	Àng
AngF	Àng
ANGf	ÀNG
ANGF	ÀNG
angj	ạng
angJ	ạng
Angj	Ạng
AngJ	Ạng
ANGj	ẠNG
ANGJ	ẠNG
angr	ảng
angR	ảng
Angr	Ảng
AngR	Ảng
ANGr	ẢNG
ANGR	ẢNG
angs	áng
angS	áng
Angs	Áng
AngS	Áng
ANGs	ÁNG
ANGS	ÁNG
angx	ãng
angX	ãng
Angx	Ãng
AngX	Ãng
ANGx	ÃNG
ANGX	ÃNG
anh	anh
Anh	Anh
ANH	ANH
anhf	ành
anhF	ành
Anhf	Ành
AnhF	Ành
ANHf	ÀNH
ANHF	ÀNH
anhj	ạnh
anhJ	ạnh
Anhj	Ạnh
AnhJ	Ạnh
ANHj	ẠNH
ANHJ	ẠNH
anhr	ảnh
anhR	ảnh
Anhr	Ảnh
AnhR	Ảnh
ANHr	ẢNH
ANHR	ẢNH
anhs	ánh
anhS	ánh
Anhs	Ánh
AnhS	Ánh
ANHs	ÁNH
ANHS	ÁNH
anhx	ãnh
anhX	ãnh
Anhx	Ãnh
AnhX	Ãnh
ANHx	ÃNH
ANHX	ÃNH
anj	ạn
anJ	ạn
Anj	Ạn
AnJ	Ạn
ANj	ẠN
ANJ	ẠN
anr	ản
anR	ản
Anr	Ản
AnR	Ản
ANr	ẢN
ANR	ẢN
ans	án
anS	án
Ans	Án
AnS	Án
ANs	ÁN
ANS	ÁN
anx	ãn
anX	ãn
Anx	Ãn
AnX	Ãn
ANx	ÃN
ANX	ÃN
ao	ao
Ao	Ao
AO	AO
aof	ào
aoF	ào
Aof	Ào
AoF	Ào
AOf	ÀO
AOF	ÀO
aoj	ạo
aoJ	ạo
Aoj	Ạo
AoJ	Ạo
AOj	ẠO
AOJ	ẠO
aor	ảo
aoR	ảo
Aor	Ảo
AoR	Ảo
AOr	ẢO
AOR	ẢO
aos	áo
aoS	áo
Aos	Áo
AoS	Áo
AOs	ÁO
AOS	ÁO
aox	ão
aoX	ão
Aox	Ão
AoX	Ão
AOx	ÃO
AOX	ÃO
ap	ap
Ap	Ap
AP	AP
apj	ạp
apJ	ạp
Apj	Ạp
ApJ	Ạp
APj	ẠP
APJ	ẠP
aps	áp
apS	áp
Aps	Áp
ApS	Áp
APs	ÁP
APS	ÁP
ar	ả
aR	ả
Ar	Ả
AR	Ả
ari	ải
aRi	ải
Ari	Ải
ArI	ẢI
ARi	Ải
ARI	ẢI
arm	ảm
aRm	ảm
Arm	Ảm
ArM	ẢM
ARm	Ảm
ARM	ẢM
arn	ản
aRn	ản
Arn	Ản
ArN	ẢN
ARn	Ản
ARN	ẢN
arng	ảng
aRng	ảng
Arng	Ảng
ArNG	ẢNG
ARng	Ảng
ARNG	ẢNG
arnh	ảnh
aRnh	ảnh
Arnh	Ảnh
ArNH	ẢNH
ARnh	Ảnh
ARNH	ẢNH
aro	ảo
aRo	ảo
Aro	Ảo
ArO	ẢO
ARo	Ảo
ARO	ẢO
aru	ảu
aRu	ảu
Aru	Ảu
ArU	ẢU
ARu	Ảu
ARU	ẢU
ary	ảy
aRy	ảy
Ary	Ảy
ArY	ẢY
ARy	Ảy
ARY	ẢY
as	á
aS	á
As	Á
AS	Á
asc	ác
aSc	ác
Asc	Ác
AsC	ÁC
ASc	Ác
ASC	ÁC
asch	ách
aSch	ách
Asch	Ách
AsCH	ÁCH
ASch	Ách
ASCH	ÁCH
asi	ái
aSi	ái
Asi	Ái
AsI	ÁI
ASi	Ái
ASI	ÁI
asm	ám
aSm	ám
Asm	Ám
AsM	ÁM
ASm	Ám
ASM	ÁM
asn	án
aSn	án
Asn	Án
AsN	ÁN
ASn	Án
ASN	ÁN
asng	áng
aSng	áng
Asng	Áng
AsNG	ÁNG
ASng	Áng
ASNG	ÁNG
asnh	ánh
aSnh	ánh
Asnh	Ánh
AsNH	ÁNH
ASnh	Ánh
ASNH	ÁNH
aso	áo
aSo	áo
Aso	Áo
AsO	ÁO
ASo	Áo
ASO	ÁO
asp	áp
aSp	áp
Asp	Áp
AsP	ÁP
ASp	Áp
ASP	ÁP
ast	át
aSt	át
Ast	Át
AsT	ÁT
ASt	Át
AST	ÁT
asu	áu
aSu	áu
Asu	Áu
AsU	ÁU
ASu	Áu
ASU	ÁU
asy	áy
aSy	áy
Asy	Áy
AsY	ÁY
ASy	Áy
ASY	ÁY
at	at
At	At
AT	AT
atj	ạt
atJ	ạt
Atj	Ạt
AtJ	Ạt
ATj	ẠT
ATJ	ẠT
ats	át
atS	át
Ats	Át
AtS	Át
ATs	ÁT
ATS	ÁT
au	au
Au	Au
AU	AU
auf	àu
auF	àu
Auf	Àu
AuF	Àu
AUf	ÀU
AUF	ÀU
auj	ạu
auJ	ạu
Auj	Ạu
AuJ	Ạu
AUj	ẠU
AUJ	ẠU
aur	ảu
auR	ảu
Aur	Ảu
AuR	Ảu
AUr	ẢU
AUR	ẢU
aus	áu
auS	áu
Aus	Áu
AuS	Áu
AUs	ÁU
AUS	ÁU
aux	ãu
auX	ãu
Aux	Ãu
AuX	Ãu
AUx	ÃU
AUX	ÃU
awc	ăc
aWc	ăc
Awc	Ăc
AwC	ĂC
AWc	Ăc
AWC	ĂC
awcj	ặc
aWcJ	ặc
Awcj	Ặc
AwCj	ẶC
AWcJ	Ặc
AWCJ	ẶC
awcs	ắc
aWcS	ắc
Awcs	Ắc
AwCs	ẮC
AWcS	Ắc
AWCS	ẮC
awfm	ằm
aWFm	ằm
Awfm	Ằm
AwfM	ẰM
AWFm	Ằm
AWFM	ẰM
awfn	ằn
aWFn	ằn
Awfn	Ằn
AwfN	ẰN
AWFn	Ằn
AWFN	ẰN
awfng	ằng
aWFng	ằng
Awfng	Ằng
AwfNG	ẰNG
AWFng	Ằng
AWFNG	ẰNG
awjc	ặc
aWJc	ặc
Awjc	Ặc
AwjC	ẶC
AWJc	Ặc
AWJC	ẶC
awjm	ặm
aWJm	ặm
Awjm	Ặm
AwjM	ẶM
AWJm	Ặm
AWJM	ẶM
awjn	ặn
aWJn	ặn
Awjn	Ặn
AwjN	ẶN
AWJn	Ặn
AWJN	ẶN
awjng	ặng
aWJng	ặng
Awjng	Ặng
AwjNG	ẶNG
AWJng	Ặng
AWJNG	ẶNG
awjp	ặp
aWJp	ặp
Awjp	Ặp
AwjP	ẶP
AWJp	Ặp
AWJP	ẶP
awjt	ặt
aWJt	ặt
Awjt	Ặt
AwjT	ẶT
AWJt	Ặt
AWJT	ẶT
awm	ăm
aWm	ăm
Awm	Ăm
AwM	ĂM
AWm	Ăm
AWM	ĂM
awmf	ằm
aWmF	ằm
Awmf	Ằm
AwMf	ẰM
AWmF	Ằm
AWMF	ẰM
awmj	ặm
aWmJ	ặm
Awmj	Ặm
AwMj	ẶM
AWmJ	Ặm
AWMJ	ẶM
awmr	ẳm
aWmR	ẳm
Awmr	Ẳm
AwMr	ẲM
AWmR	Ẳm
AWMR	ẲM
awms	ắm
aWmS	ắm
Awms	Ắm
AwMs	ẮM
AWmS	Ắm
AWMS	ẮM
awmx	ẵm
aWmX	ẵm
Awmx	Ẵm
AwMx	ẴM
AWmX	Ẵm
AWMX	ẴM
awn	ăn
aWn	ăn
Awn	Ăn
AwN	ĂN
AWn	Ăn
AWN	ĂN
awnf	ằn
aWnF	ằn
Awnf	Ằn
AwNf	ẰN
AWnF	Ằn
AWNF	ẰN
awng	ăng
aWng	ăng
Awng	Ăng
AwNG	ĂNG
AWng	Ăng
AWNG	ĂNG
awngf	ằng
aWngF	ằng
Awngf	Ằng
AwNGf	ẰNG
AWngF	Ằng
AWNGF	ẰNG
awngj	ặng
aWngJ	ặng
Awngj	Ặng
AwNGj	ẶNG
AWngJ	Ặng
AWNGJ	ẶNG
awngr	ẳng
aWngR	ẳng
Awngr	Ẳng
AwNGr	ẲNG
AWngR	Ẳng
AWNGR	ẲNG
awngs	ắng
aWngS	ắng
Awngs	Ắng
AwNGs	ẮNG
AWngS	Ắng
AWNGS	ẮNG
awngx	ẵng
aWngX	ẵng
Awngx	Ẵng
AwNGx	ẴNG
AWngX	Ẵng
AWNGX	ẴNG
awnj	ặn
aWnJ	ặn
Awnj	Ặn
AwNj	ẶN
AWnJ	Ặn
AWNJ	ẶN
awnr	ẳn
aWnR	ẳn
Awnr	Ẳn
AwNr	ẲN
AWnR	Ẳn
AWNR	ẲN
awns	ắn
aWnS	ắn
Awns	Ắn
AwNs	ẮN
AWnS	Ắn
AWNS	ẮN
awnx	ẵn
aWnX	ẵn
Awnx	Ẵn
AwNx	ẴN
AWnX	Ẵn
AWNX	ẴN
awp	ăp
aWp	ăp
Awp	Ăp
AwP	ĂP
AWp	Ăp
AWP	ĂP
awpj	ặp
aWpJ	ặp
Awpj	Ặp
AwPj	ẶP
AWpJ	Ặp
AWPJ	ẶP
awps	ắp
aWpS	ắp
Awps	Ắp
AwPs	ẮP
AWpS	Ắp
AWPS	ẮP
awrm	ẳm
aWRm	ẳm
Awrm	Ẳm
AwrM	ẲM
AWRm	Ẳm
AWRM	ẲM
awrn	ẳn
aWRn	ẳn
Awrn	Ẳn
AwrN	ẲN
AWRn	Ẳn
AWRN	ẲN
awrng	ẳng
aWRng	ẳng
Awrng	Ẳng
AwrNG	ẲNG
AWRng	Ẳng
AWRNG	ẲNG
awsc	ắc
aWSc	ắc
Awsc	Ắc
AwsC	ẮC
AWSc	Ắc
AWSC	ẮC
awsm	ắm
aWSm	ắm
Awsm	Ắm
AwsM	ẮM
AWSm	Ắm
AWSM	ẮM
awsn	ắn
aWSn	ắn
Awsn	Ắn
AwsN	ẮN
AWSn	Ắn
AWSN	ẮN
awsng	ắng
aWSng	ắng
Awsng	Ắng
AwsNG	ẮNG
AWSng	Ắng
AWSNG	ẮNG
awsp	ắp
aWSp	ắp
Awsp	Ắp
AwsP	ẮP
AWSp	Ắp
AWSP	ẮP
awst	ắt
aWSt	ắt
Awst	Ắt
AwsT	ẮT
AWSt	Ắt
AWST	ẮT
awt	ăt
aWt	ăt
Awt	Ăt
AwT	ĂT
AWt	Ăt
AWT	ĂT
awtj	ặt
aWtJ	ặt
Awtj	Ặt
AwTj	ẶT
AWtJ	Ặt
AWTJ	ẶT
awts	ắt
aWtS	ắt
Awts	Ắt
AwTs	ẮT
AWtS	Ắt
AWTS	ẮT
awxm	ẵm
aWXm	ẵm
Awxm	Ẵm
AwxM	ẴM
AWXm	Ẵm
AWXM	ẴM
awxn	ẵn
aWXn	ẵn
Awxn	Ẵn
AwxN	ẴN
AWXn	Ẵn
AWXN	ẴN
awxng	ẵng
aWXng	ẵng
Awxng	Ẵng
AwxNG	ẴNG
AWXng	Ẵng
AWXNG	ẴNG
ax	ã
aX	ã
Ax	Ã
AX	Ã
axi	ãi
aXi	ãi
Axi	Ãi
AxI	ÃI
AXi	Ãi
AXI	ÃI
axm	ãm
aXm	ãm
Axm	Ãm
AxM	ÃM
AXm	Ãm
AXM	ÃM
axn	ãn
aXn	ãn
Axn	Ãn
AxN	ÃN
AXn	Ãn
AXN	ÃN
axng	ãng
aXng	ãng
Axng	Ãng
AxNG	ÃNG
AXng	Ãng
AXNG	ÃNG
axnh	ãnh
aXnh	ãnh
Axnh	Ãnh
AxNH	ÃNH
AXnh	Ãnh
AXNH	ÃNH
axo	ão
aXo	ão
Axo	Ão
AxO	ÃO
AXo	Ão
AXO	ÃO
axu	ãu
aXu	ãu
Axu	Ãu
AxU	ÃU
AXu	Ãu
AXU	ÃU
axy	ãy
aXy	ãy
Axy	Ãy
AxY	ÃY
AXy	Ãy
AXY	ÃY
ay	ay
Ay	Ay
AY	AY
ayf	ày
ayF	ày
Ayf	Ày
AyF	Ày
AYf	ÀY
AYF	ÀY
ayj	ạy
ayJ	ạy
Ayj	Ạy
AyJ	Ạy
AYj	ẠY
AYJ	ẠY
ayr	ảy
ayR	ảy
Ayr	Ảy
AyR	Ảy
AYr	ẢY
AYR	ẢY
ays	áy
ayS	áy
Ays	Áy
AyS	Áy
AYs	ÁY
AYS	ÁY
ayx	ãy
ayX	ãy
Ayx	Ãy
AyX	Ãy
AYx	ÃY
AYX	ÃY
dd	đ
Dd	Đ
DD	Đ
e	e
E	E
ec	ec
Ec	Ec
EC	EC
ecj	ẹc
ecJ	ẹc
Ecj	Ẹc
EcJ	Ẹc
ECj	ẸC
ECJ	ẸC
ecs	éc
ecS	éc
Ecs	Éc
EcS	Éc
ECs	ÉC
ECS	ÉC
ee	ê
Ee	Ê
EE	Ê
eech	êch
Eech	Êch
EeCH	ÊCH
EEch	Êch
EECH	ÊCH
eechj	ệch
eechJ	ệch
Eechj	Ệch
EeCHj	ỆCH
EEchJ	Ệch
EECHJ	ỆCH
eechs	ếch
eechS	ếch
Eechs	Ếch
EeCHs	ẾCH
EEchS	Ếch
EECHS	ẾCH
eef	ề
eeF	ề
Eef	Ề
EEF	Ề
eefm	ềm
eeFm	ềm
Eefm	Ềm
EefM	ỀM
EEFm	Ềm
EEFM	ỀM
eefn	ền
eeFn	ền
Eefn	Ền
EefN	ỀN
EEFn	Ền
EEFN	ỀN
eefnh	ềnh
eeFnh	ềnh
Eefnh	Ềnh
EefNH	ỀNH
EEFnh	Ềnh
EEFNH	ỀNH
eefu	ều
eeFu	ều
Eefu	Ều
EefU	ỀU
EEFu	Ều
EEFU	ỀU
eej	ệ
eeJ	ệ
Eej	Ệ
EEJ	Ệ
eejch	ệch
eeJch	ệch
Eejch	Ệch
EejCH	ỆCH
EEJch	Ệch
EEJCH	ỆCH
eejm	ệm
eeJm	ệm
Eejm	Ệm
EejM	ỆM
EEJm	Ệm
EEJM	ỆM
eejn	ện
eeJn	ện
Eejn	Ện
EejN	ỆN
EEJn	Ện
EEJN	ỆN
eejnh	ệnh
eeJnh	ệnh
Eejnh	Ệnh
EejNH	ỆNH
EEJnh	Ệnh
EEJNH	ỆNH
eejp	ệp
eeJp	ệp
Eejp	Ệp
EejP	ỆP
EEJp	Ệp
EEJP	ỆP
eejt	ệt
eeJt	ệt
Eejt	Ệt
EejT	ỆT
EEJt	Ệt
EEJT	ỆT
eeju	ệu
eeJu	ệu
Eeju	Ệu
EejU	ỆU
EEJu	Ệu
EEJU	ỆU
eem	êm
Eem	Êm
EeM	ÊM
EEm	Êm
EEM	ÊM
eemf	ềm
eemF	ềm
Eemf	Ềm
EeMf	ỀM
EEmF	Ềm
EEMF	ỀM
eemj	ệm
eemJ	ệm
Eemj	Ệm
EeMj	ỆM
EEmJ	Ệm
EEMJ	ỆM
eemr	ểm
eemR	ểm
Eemr	Ểm
EeMr	ỂM
EEmR	Ểm
EEMR	ỂM
eems	ếm
eemS	ếm
Eems	Ếm
EeMs	ẾM
EEmS	Ếm
EEMS	ẾM
eemx	ễm
eemX	ễm
Eemx	Ễm
EeMx	ỄM
EEmX	Ễm
EEMX	ỄM
een	ên
Een	Ên
EeN	ÊN
EEn	Ên
EEN	ÊN
eenf	ền
eenF	ền
Eenf	Ền
EeNf	ỀN
EEnF	Ền
EENF	ỀN
eenh	ênh
Eenh	Ênh
EeNH	ÊNH
EEnh	Ênh
EENH	ÊNH
eenhf	ềnh
eenhF	ềnh
Eenhf	Ềnh
EeNHf	ỀNH
EEnhF	Ềnh
EENHF	ỀNH
eenhj	ệnh
eenhJ	ệnh
Eenhj	Ệnh
EeNHj	ỆNH
EEnhJ	Ệnh
EENHJ	ỆNH
eenhr	ểnh
eenhR	ểnh
Eenhr	Ểnh
EeNHr	ỂNH
EEnhR	Ểnh
EENHR	ỂNH
eenhs	ếnh
eenhS	ếnh
Eenhs	Ếnh
EeNHs	ẾNH
EEnhS	Ếnh
EENHS	ẾNH
eenhx	ễnh
eenhX	ễnh
Eenhx	Ễnh
EeNHx	ỄNH
EEnhX	Ễnh
EENHX	ỄNH
eenj	ện
eenJ	ện
Eenj	Ện
EeNj	ỆN
EEnJ	Ện
EENJ	ỆN
eenr	ển
eenR	ển
Eenr	Ển
EeNr	ỂN
EEnR	Ển
EENR	ỂN
eens	ến
eenS	ến
Eens	Ến
EeNs	ẾN
EEnS	Ến
EENS	ẾN
eenx	ễn
eenX	ễn
Eenx	Ễn
EeNx	ỄN
EEnX	Ễn
EENX	ỄN
eep	êp
Eep	Êp
EeP	ÊP
EEp	Êp
EEP	ÊP
eepj	ệp
eepJ	ệp
Eepj	Ệp
EePj	ỆP
EEpJ	Ệp
EEPJ	ỆP
eeps	ếp
eepS	ếp
Eeps	Ếp
EePs	ẾP
EEpS	Ếp
EEPS	ẾP
eer	ể
eeR	ể
Eer	Ể
EER	Ể
eerm	ểm
eeRm	ểm
Eerm	Ểm
EerM	ỂM
EERm	Ểm
EERM	ỂM
eern	ển
eeRn	ển
Eern	Ển
EerN	ỂN
EERn	Ển
EERN	ỂN
eernh	ểnh
eeRnh	ểnh
Eernh	Ểnh
EerNH	ỂNH
EERnh	Ểnh
EERNH	ỂNH
eeru	ểu
eeRu	ểu
Eeru	Ểu
EerU	ỂU
EERu	Ểu
EERU	ỂU
ees	ế
eeS	ế
Ees	Ế
EES	Ế
eesch	ếch
eeSch	ếch
Eesch	Ếch
EesCH	ẾCH
EESch	Ếch
EESCH	ẾCH
eesm	ếm
eeSm	ếm
Eesm	Ếm
EesM	ẾM
EESm	Ếm
EESM	ẾM
eesn	ến
eeSn	ến
Eesn	Ến
EesN	ẾN
EESn	Ến
EESN	ẾN
eesnh	ếnh
eeSnh	ếnh
Eesnh	Ếnh
EesNH	ẾNH
EESnh	Ếnh
EESNH	ẾNH
eesp	ếp
eeSp	ếp
Eesp	Ếp
EesP	ẾP
EESp	Ếp
EESP	ẾP
eest	ết
eeSt	ết
Eest	Ết
EesT	ẾT
EESt	Ết
EEST	ẾT
eesu	ếu
eeSu	ếu
Eesu	Ếu
EesU	ẾU
EESu	Ếu
EESU	ẾU
eet	êt
Eet	Êt
EeT	ÊT
EEt	Êt
EET	ÊT
eetj	ệt
eetJ	ệt
Eetj	Ệt
EeTj	ỆT
EEtJ	Ệt
EETJ	ỆT
eets	ết
eetS	ết
Eets	Ết
EeTs	ẾT
EEtS	Ết
EETS	ẾT
eeu	êu
Eeu	Êu
EeU	ÊU
EEu	Êu
EEU	ÊU
eeuf	ều
eeuF	ều
Eeuf	Ều
EeUf	ỀU
EEuF	Ều
EEUF	ỀU
eeuj	ệu
eeuJ	ệu
Eeuj	Ệu
EeUj	ỆU
EEuJ	Ệu
EEUJ	ỆU
eeur	ểu
eeuR	ểu
Eeur	Ểu
EeUr	ỂU
EEuR	Ểu
EEUR	ỂU
eeus	ếu
eeuS	ếu
Eeus	Ếu
EeUs	ẾU
EEuS	Ếu
EEUS	ẾU
eeux	ễu
eeuX	ễu
Eeux	Ễu
EeUx	ỄU
EEuX	Ễu
EEUX	ỄU
eex	ễ
eeX	ễ
Eex	Ễ
EEX	Ễ
eexm	ễm
eeXm	ễm
Eexm	Ễm
EexM	ỄM
EEXm	Ễm
EEXM	ỄM
eexn	ễn
eeXn	ễn
Eexn	Ễn
EexN	ỄN
EEXn	Ễn
EEXN	ỄN
eexnh	ễnh
eeXnh	ễnh
Eexnh	Ễnh
EexNH	ỄNH
EEXnh	Ễnh
EEXNH	ỄNH
eexu	ễu
eeXu	ễu
Eexu	Ễu
EexU	ỄU
EEXu	Ễu
EEXU	ỄU
ef	è
eF	è
Ef	È
EF	È
efm	èm
eFm	èm
Efm	Èm
EfM	ÈM
EFm	Èm
EFM	ÈM
efn	èn
eFn	èn
Efn	Èn
EfN	ÈN
EFn	Èn
EFN	ÈN
efo	èo
eFo	èo
Efo	Èo
EfO	ÈO
EFo	Èo
EFO	ÈO
ej	ẹ
eJ	ẹ
Ej	Ẹ
EJ	Ẹ
ejc	ẹc
eJc	ẹc
Ejc	Ẹc
EjC	ẸC
EJc	Ẹc
EJC	ẸC
ejm	ẹm
eJm	ẹm
Ejm	Ẹm
EjM	ẸM
EJm	Ẹm
EJM	ẸM
ejn	ẹn
eJn	ẹn
Ejn	Ẹn
EjN	ẸN
EJn	Ẹn
EJN	ẸN
ejo	ẹo
eJo	ẹo
Ejo	Ẹo
EjO	ẸO
EJo	Ẹo
EJO	ẸO
ejp	ẹp
eJp	ẹp
Ejp	Ẹp
EjP	ẸP
EJp	Ẹp
EJP	ẸP
ejt	ẹt
eJt	ẹt
Ejt	Ẹt
EjT	ẸT
EJt	Ẹt
EJT	ẸT
em	em
Em	Em
EM	EM
emf	èm
emF	èm
Emf	Èm
EmF	Èm
EMf	ÈM
EMF	ÈM
emj	ẹm
emJ	ẹm
Emj	Ẹm
EmJ	Ẹm
EMj	ẸM
EMJ	ẸM
emr	ẻm
emR	ẻm
Emr	Ẻm
EmR	Ẻm
EMr	ẺM
EMR	ẺM
ems	ém
emS	ém
Ems	Ém
EmS	Ém
EMs	ÉM
EMS	ÉM
emx	ẽm
emX	ẽm
Emx	Ẽm
EmX	Ẽm
EMx	ẼM
EMX	ẼM
en	en
En	En
EN	EN
enf	èn
enF	èn
Enf	Èn
EnF	Èn
ENf	ÈN
ENF	ÈN
eng	eng
Eng	Eng
ENG	ENG
engr	ẻng
engR	ẻng
Engr	Ẻng
EngR	Ẻng
ENGr	ẺNG
ENGR	ẺNG
enj	ẹn
enJ	ẹn
Enj	Ẹn
EnJ	Ẹn
ENj	ẸN
ENJ	ẸN
enr	ẻn
enR	ẻn
Enr	Ẻn
EnR	Ẻn
ENr	ẺN
ENR	ẺN
ens	én
enS	én
Ens	Én
EnS	Én
ENs	ÉN
ENS	ÉN
enx	ẽn
enX	ẽn
Enx	Ẽn
EnX	Ẽn
ENx	ẼN
ENX	ẼN
eo	eo
Eo	Eo
EO	EO
eof	èo
eoF	èo
Eof	Èo
EoF	Èo
EOf	ÈO
EOF	ÈO
eoj	ẹo
eoJ	ẹo
Eoj	Ẹo
EoJ	Ẹo
EOj	ẸO
EOJ	ẸO
eor	ẻo
eoR	ẻo
Eor	Ẻo
EoR	Ẻo
EOr	ẺO
EOR	ẺO
eos	éo
eoS	éo
Eos	Éo
EoS	Éo
EOs	ÉO
EOS	ÉO
eox	ẽo
eoX	ẽo
Eox	Ẽo
EoX	Ẽo
EOx	ẼO
EOX	ẼO
ep	ep
Ep	Ep
EP	EP
epj	ẹp
epJ	ẹp
Epj	Ẹp
EpJ	Ẹp
EPj	ẸP
EPJ	ẸP
eps	ép
epS	ép
Eps	Ép
EpS	Ép
EPs	ÉP
EPS	ÉP
er	ẻ
eR	ẻ
Er	Ẻ
ER	Ẻ
erm	ẻm
eRm	ẻm
Erm	Ẻm
ErM	ẺM
ERm	Ẻm
ERM	ẺM
ern	ẻn
eRn	ẻn
Ern	Ẻn
ErN	ẺN
ERn	Ẻn
ERN	ẺN
erng	ẻng
eRng	ẻng
Erng	Ẻng
ErNG	ẺNG
ERng	Ẻng
ERNG	ẺNG
ero	ẻo
eRo	ẻo
Ero	Ẻo
ErO	ẺO
ERo	Ẻo
ERO	ẺO
es	é
eS	é
Es	É
ES	É
esc	éc
eSc	éc
Esc	Éc
EsC	ÉC
ESc	Éc
ESC	ÉC
esm	ém
eSm	ém
Esm	Ém
EsM	ÉM
ESm	Ém
ESM	ÉM
esn	én
eSn	én
Esn	Én
EsN	ÉN
ESn	Én
ESN	ÉN
eso	éo
eSo	éo
Eso	Éo
EsO	ÉO
ESo	Éo
ESO	ÉO
esp	ép
eSp	ép
Esp	Ép
EsP	ÉP
ESp	Ép
ESP	ÉP
est	ét
eSt	ét
Est	Ét
EsT	ÉT
ESt	Ét
EST	ÉT
et	et
Et	Et
ET	ET
etj	ẹt
etJ	ẹt
Etj	Ẹt
EtJ	Ẹt
ETj	ẸT
ETJ	ẸT
ets	ét
etS	ét
Ets	Ét
EtS	Ét
ETs	ÉT
ETS	ÉT
ex	ẽ
eX	ẽ
Ex	Ẽ
EX	Ẽ
exm	ẽm
eXm	ẽm
Exm	Ẽm
ExM	ẼM
EXm	Ẽm
EXM	ẼM
exn	ẽn
eXn	ẽn
Exn	Ẽn
ExN	ẼN
EXn	Ẽn
EXN	ẼN
exo	ẽo
eXo	ẽo
Exo	Ẽo
ExO	ẼO
EXo	Ẽo
EXO	ẼO
i	i
I	I
ia	ia
Ia	Ia
IA	IA
iaf	ìa
iaF	ìa
Iaf	Ìa
IaF	Ìa
IAf	ÌA
IAF	ÌA
iaj	ịa
iaJ	ịa
Iaj	Ịa
IaJ	Ịa
IAj	ỊA
IAJ	ỊA
iar	ỉa
iaR	ỉa
Iar	Ỉa
IaR	Ỉa
IAr	ỈA
IAR	ỈA
ias	ía
iaS	ía
Ias	Ía
IaS	Ía
IAs	ÍA
IAS	ÍA
iax	ĩa
iaX	ĩa
Iax	Ĩa
IaX	Ĩa
IAx	ĨA
IAX	ĨA
ich	ich
Ich	Ich
ICH	ICH
ichj	ịch
ichJ	ịch
Ichj	Ịch
IchJ	Ịch
ICHj	ỊCH
ICHJ	ỊCH
ichs	ích
ichS	ích
Ichs	Ích
IchS	Ích
ICHs	ÍCH
ICHS	ÍCH
ieec	iêc
Ieec	Iêc
IEeC	IÊC
IEEC	IÊC
ieecj	iệc
ieecJ	iệc
Ieecj	Iệc
IeecJ	Iệc
IEeCj	IỆC
IEECJ	IỆC
ieecs	iếc
ieecS	iếc
Ieecs	Iếc
IeecS	Iếc
IEeCs	IẾC
IEECS	IẾC
ieefm	iềm
ieeFm	iềm
Ieefm	Iềm
IeeFm	Iềm
IEefM	IỀM
IEEFM	IỀM
ieefn	iền
ieeFn	iền
Ieefn	Iền
IeeFn	Iền
IEefN	IỀN
IEEFN	IỀN
ieefng	iềng
ieeFng	iềng
Ieefng	Iềng
IeeFng	Iềng
IEefNG	IỀNG
IEEFNG	IỀNG
ieefu	iều
ieeFu	iều
Ieefu	Iều
IeeFu	Iều
IEefU	IỀU
IEEFU	IỀU
ieejc	iệc
ieeJc	iệc
Ieejc	Iệc
IeeJc	Iệc
IEejC	IỆC
IEEJC	IỆC
ieejm	iệm
ieeJm	iệm
Ieejm	Iệm
IeeJm	Iệm
IEejM	IỆM
IEEJM	IỆM
ieejn	iện
ieeJn	iện
Ieejn	Iện
IeeJn	Iện
IEejN	IỆN
IEEJN	IỆN
ieejng	iệng
ieeJng	iệng
Ieejng	Iệng
IeeJng	Iệng
IEejNG	IỆNG
IEEJNG	IỆNG
ieejp	iệp
ieeJp	iệp
Ieejp	Iệp
IeeJp	Iệp
IEejP	IỆP
IEEJP	IỆP
ieejt	iệt
ieeJt	iệt
Ieejt	Iệt
IeeJt	Iệt
IEejT	IỆT
IEEJT	IỆT
ieeju	iệu
ieeJu	iệu
Ieeju	Iệu
IeeJu	Iệu
IEejU	IỆU
IEEJU	IỆU
ieem	iêm
Ieem	Iêm
IEeM	IÊM
IEEM	IÊM
ieemf	iềm
ieemF	iềm
Ieemf	Iềm
IeemF	Iềm
IEeMf	IỀM
IEEMF	IỀM
ieemj	iệm
ieemJ	iệm
Ieemj	Iệm
IeemJ	Iệm
IEeMj	IỆM
IEEMJ	IỆM
ieemr	iểm
ieemR	iểm
Ieemr	Iểm
IeemR	Iểm
IEeMr	IỂM
IEEMR	IỂM
ieems	iếm
ieemS	iếm
Ieems	Iếm
IeemS	Iếm
IEeMs	IẾM
IEEMS	IẾM
ieemx	iễm
ieemX	iễm
Ieemx	Iễm
IeemX	Iễm
IEeMx	IỄM
IEEMX	IỄM
ieen	iên
Ieen	Iên
IEeN	IÊN
IEEN	IÊN
ieenf	iền
ieenF	iền
Ieenf	Iền
IeenF	Iền
IEeNf	IỀN
IEENF	IỀN
ieeng	iêng
Ieeng	Iêng
IEeNG	IÊNG
IEENG	IÊNG
ieengf	iềng
ieengF	iềng
Ieengf	Iềng
IeengF	Iềng
IEeNGf	IỀNG
IEENGF	IỀNG
ieengj	iệng
ieengJ	iệng
Ieengj	Iệng
IeengJ	Iệng
IEeNGj	IỆNG
IEENGJ	IỆNG
ieengr	iểng
ieengR	iểng
Ieengr	Iểng
IeengR	Iểng
IEeNGr	IỂNG
IEENGR	IỂNG
ieengs	iếng
ieengS	iếng
Ieengs	Iếng
IeengS	Iếng
IEeNGs	IẾNG
IEENGS	IẾNG
ieengx	iễng
ieengX	iễng
Ieengx	Iễng
IeengX	Iễng
IEeNGx	IỄNG
IEENGX	IỄNG
ieenj	iện
ieenJ	iện
Ieenj	Iện
IeenJ	Iện
IEeNj	IỆN
IEENJ	IỆN
ieenr	iển
ieenR	iển
Ieenr	Iển
IeenR	Iển
IEeNr	IỂN
IEENR	IỂN
ieens	iến
ieenS	iến
Ieens	Iến
IeenS	Iến
IEeNs	IẾN
IEENS	IẾN
ieenx	iễn
ieenX	iễn
Ieenx	Iễn
IeenX	Iễn
IEeNx	IỄN
IEENX	IỄN
ieep	iêp
Ieep	Iêp
IEeP	IÊP
IEEP	IÊP
ieepj	iệp
ieepJ	iệp
Ieepj	Iệp
IeepJ	Iệp
IEePj	IỆP
IEEPJ	IỆP
ieeps	iếp
ieepS	iếp
Ieeps	Iếp
IeepS	Iếp
IEePs	IẾP
IEEPS	IẾP
ieerm	iểm
ieeRm	iểm
Ieerm	Iểm
IeeRm	Iểm
IEerM	IỂM
IEERM	IỂM
ieern	iển
ieeRn	iển
Ieern	Iển
IeeRn	Iển
IEerN	IỂN
IEERN	IỂN
ieerng	iểng
ieeRng	iểng
Ieerng	Iểng
IeeRng	Iểng
IEerNG	IỂNG
IEERNG	IỂNG
ieeru	iểu
ieeRu	iểu
Ieeru	Iểu
IeeRu	Iểu
IEerU	IỂU
IEERU	IỂU
ieesc	iếc
ieeSc	iếc
Ieesc	Iếc
IeeSc	Iếc
IEesC	IẾC
IEESC	IẾC
ieesm	iếm
ieeSm	iếm
Ieesm	Iếm
IeeSm	Iếm
IEesM	IẾM
IEESM	IẾM
ieesn	iến
ieeSn	iến
Ieesn	Iến
IeeSn	Iến
IEesN	IẾN
IEESN	IẾN
ieesng	iếng
ieeSng	iếng
Ieesng	Iếng
IeeSng	Iếng
IEesNG	IẾNG
IEESNG	IẾNG
ieesp	iếp
ieeSp	iếp
Ieesp	Iếp
IeeSp	Iếp
IEesP	IẾP
IEESP	IẾP
ieest	iết
ieeSt	iết
Ieest	Iết
IeeSt	Iết
IEesT	IẾT
IEEST	IẾT
ieesu	iếu
ieeSu	iếu
Ieesu	Iếu
IeeSu	Iếu
IEesU	IẾU
IEESU	IẾU
ieet	iêt
Ieet	Iêt
IEeT	IÊT
IEET	IÊT
ieetj	iệt
ieetJ	iệt
Ieetj	Iệt
IeetJ	Iệt
IEeTj	IỆT
IEETJ	IỆT
ieets	iết
ieetS	iết
Ieets	Iết
IeetS	Iết
IEeTs	IẾT
IEETS	IẾT
ieeu	iêu
Ieeu	Iêu
IEeU	IÊU
IEEU	IÊU
ieeuf	iều
ieeuF	iều
Ieeuf	Iều
IeeuF	Iều
IEeUf	IỀU
IEEUF	IỀU
ieeuj	iệu
ieeuJ	iệu
Ieeuj	Iệu
IeeuJ	Iệu
IEeUj	IỆU
IEEUJ	IỆU
ieeur	iểu
ieeuR	iểu
Ieeur	Iểu
IeeuR	Iểu
IEeUr	IỂU
IEEUR	IỂU
ieeus	iếu
ieeuS	iếu
Ieeus	Iếu
IeeuS	Iếu
IEeUs	IẾU
IEEUS	IẾU
ieeux	iễu
ieeuX	iễu
Ieeux	Iễu
IeeuX	Iễu
IEeUx	IỄU
IEEUX	IỄU
ieexm	iễm
ieeXm	iễm
Ieexm	Iễm
IeeXm	Iễm
IEexM	IỄM
IEEXM	IỄM
ieexn	iễn
ieeXn	iễn
Ieexn	Iễn
IeeXn	Iễn
IEexN	IỄN
IEEXN	IỄN
ieexng	iễng
ieeXng	iễng
Ieexng	Iễng
IeeXng	Iễng
IEexNG	IỄNG
IEEXNG	IỄNG
ieexu	iễu
ieeXu	iễu
Ieexu	Iễu
IeeXu	Iễu
IEexU	IỄU
IEEXU	IỄU
if	ì
iF	ì
If	Ì
IF	Ì
ifa	ìa
iFa	ìa
Ifa	Ìa
IfA	ÌA
IFa	Ìa
IFA	ÌA
ifm	ìm
iFm	ìm
Ifm	Ìm
IfM	ÌM
IFm	Ìm
IFM	ÌM
ifn	ìn
iFn	ìn
Ifn	Ìn
IfN	ÌN
IFn	Ìn
IFN	ÌN
ifnh	ình
iFnh	ình
Ifnh	Ình
IfNH	ÌNH
IFnh	Ình
IFNH	ÌNH
ifu	ìu
iFu	ìu
Ifu	Ìu
IfU	ÌU
IFu	Ìu
IFU	ÌU
ij	ị
iJ	ị
Ij	Ị
IJ	Ị
ija	ịa
iJa	ịa
Ija	Ịa
IjA	ỊA
IJa	Ịa
IJA	ỊA
ijch	ịch
iJch	ịch
Ijch	Ịch
IjCH	ỊCH
IJch	Ịch
IJCH	ỊCH
ijm	ịm
iJm	ịm
Ijm	Ịm
IjM	ỊM
IJm	Ịm
IJM	ỊM
ijn	ịn
iJn	ịn
Ijn	Ịn
IjN	ỊN
IJn	Ịn
IJN	ỊN
ijnh	ịnh
iJnh	ịnh
Ijnh	Ịnh
IjNH	ỊNH
IJnh	Ịnh
IJNH	ỊNH
ijp	ịp
iJp	ịp
Ijp	Ịp
IjP	ỊP
IJp	Ịp
IJP	ỊP
ijt	ịt
iJt	ịt
Ijt	Ịt
IjT	ỊT
IJt	Ịt
IJT	ỊT
iju	ịu
iJu	ịu
Iju	Ịu
IjU	ỊU
IJu	Ịu
IJU	ỊU
im	im
Im	Im
IM	IM
imf	ìm
imF	ìm
Imf	Ìm
ImF	Ìm
IMf	ÌM
IMF	ÌM
imj	ịm
imJ	ịm
Imj	Ịm
ImJ	Ịm
IMj	ỊM
IMJ	ỊM
imr	ỉm
imR	ỉm
Imr	Ỉm
ImR	Ỉm
IMr	ỈM
IMR	ỈM
ims	ím
imS	ím
Ims	Ím
ImS	Ím
IMs	ÍM
IMS	ÍM
imx	ĩm
imX	ĩm
Imx	Ĩm
ImX	Ĩm
IMx	ĨM
IMX	ĨM
in	in
In	In
IN	IN
inf	ìn
inF	ìn
Inf	Ìn
InF	Ìn
INf	ÌN
INF	ÌN
inh	inh
Inh	Inh
INH	INH
inhf	ình
inhF	ình
Inhf	Ình
InhF	Ình
INHf	ÌNH
INHF	ÌNH
inhj	ịnh
inhJ	ịnh
Inhj	Ịnh
InhJ	Ịnh
INHj	ỊNH
INHJ	ỊNH
inhr	ỉnh
inhR	ỉnh
Inhr	Ỉnh
InhR	Ỉnh
INHr	ỈNH
INHR	ỈNH
inhs	ính
inhS	ính
Inhs	Ính
InhS	Ính
INHs	ÍNH
INHS	ÍNH
inhx	ĩnh
inhX	ĩnh
Inhx	Ĩnh
InhX	Ĩnh
INHx	ĨNH
INHX	ĨNH
inj	ịn
inJ	ịn
Inj	Ịn
InJ	Ịn
INj	ỊN
INJ	ỊN
inr	ỉn
inR	ỉn
Inr	Ỉn
InR	Ỉn
INr	ỈN
INR	ỈN
ins	ín
inS	ín
Ins	Ín
InS	Ín
INs	ÍN
INS	ÍN
inx	ĩn
inX	ĩn
Inx	Ĩn
InX	Ĩn
INx	ĨN
INX	ĨN
ip	ip
Ip	Ip
IP	IP
ipj	ịp
ipJ	ịp
Ipj	Ịp
IpJ	Ịp
IPj	ỊP
IPJ	ỊP
ips	íp
ipS	íp
Ips	Íp
IpS	Íp
IPs	ÍP
IPS	ÍP
ir	ỉ
iR	ỉ
Ir	Ỉ
IR	Ỉ
ira	ỉa
iRa	ỉa
Ira	Ỉa
IrA	ỈA
IRa	Ỉa
IRA	ỈA
irm	ỉm
iRm	ỉm
Irm	Ỉm
IrM	ỈM
IRm	Ỉm
IRM	ỈM
irn	ỉn
iRn	ỉn
Irn	Ỉn
IrN	ỈN
IRn	Ỉn
IRN	ỈN
irnh	ỉnh
iRnh	ỉnh
Irnh	Ỉnh
IrNH	ỈNH
IRnh	Ỉnh
IRNH	ỈNH
iru	ỉu
iRu	ỉu
Iru	Ỉu
IrU	ỈU
IRu	Ỉu
IRU	ỈU
is	í
iS	í
Is	Í
IS	Í
isa	ía
iSa	ía
Isa	Ía
IsA	ÍA
ISa	Ía
ISA	ÍA
isch	ích
iSch	ích
Isch	Ích
IsCH	ÍCH
ISch	Ích
ISCH	ÍCH
ism	ím
iSm	ím
Ism	Ím
IsM	ÍM
ISm	Ím
ISM	ÍM
isn	ín
iSn	ín
Isn	Ín
IsN	ÍN
ISn	Ín
ISN	ÍN
isnh	ính
iSnh	ính
Isnh	Ính
IsNH	ÍNH
ISnh	Ính
ISNH	ÍNH
isp	íp
iSp	íp
Isp	Íp
IsP	ÍP
ISp	Íp
ISP	ÍP
ist	ít
iSt	ít
Ist	Ít
IsT	ÍT
ISt	Ít
IST	ÍT
isu	íu
iSu	íu
Isu	Íu
IsU	ÍU
ISu	Íu
ISU	ÍU
it	it
It	It
IT	IT
itj	ịt
itJ	ịt
Itj	Ịt
ItJ	Ịt
ITj	ỊT
ITJ	ỊT
its	ít
itS	ít
Its	Ít
ItS	Ít
ITs	ÍT
ITS	ÍT
iu	iu
Iu	Iu
IU	IU
iuf	ìu
iuF	ìu
Iuf	Ìu
IuF	Ìu
IUf	ÌU
IUF	ÌU
iuj	ịu
iuJ	ịu
Iuj	Ịu
IuJ	Ịu
IUj	ỊU
IUJ	ỊU
iur	ỉu
iuR	ỉu
Iur	Ỉu
IuR	Ỉu
IUr	ỈU
IUR	ỈU
ius	íu
iuS	íu
Ius	Íu
IuS	Íu
IUs	ÍU
IUS	ÍU
iux	ĩu
iuX	ĩu
Iux	Ĩu
IuX	Ĩu
IUx	ĨU
IUX	ĨU
ix	ĩ
iX	ĩ
Ix	Ĩ
IX	Ĩ
ixa	ĩa
iXa	ĩa
Ixa	Ĩa
IxA	ĨA
IXa	Ĩa
IXA	ĨA
ixm	ĩm
iXm	ĩm
Ixm	Ĩm
IxM	ĨM
IXm	Ĩm
IXM	ĨM
ixn	ĩn
iXn	ĩn
Ixn	Ĩn
IxN	ĨN
IXn	Ĩn
IXN	ĨN
ixnh	ĩnh
iXnh	ĩnh
Ixnh	Ĩnh
IxNH	ĨNH
IXnh	Ĩnh
IXNH	ĨNH
ixu	ĩu
iXu	ĩu
Ixu	Ĩu
IxU	ĨU
IXu	Ĩu
IXU	ĨU
o	o
O	O
oa	oa
Oa	Oa
OA	OA
oac	oac
Oac	Oac
OAC	OAC
oach	oach
Oach	Oach
OACH	OACH
oachj	oạch
oachJ	oạch
Oachj	Oạch
OachJ	Oạch
OACHj	OẠCH
OACHJ	OẠCH
oachs	oách
oachS	oách
Oachs	Oách
OachS	Oách
OACHs	OÁCH
OACHS	OÁCH
oacj	oạc
oacJ	oạc
Oacj	Oạc
OacJ	Oạc
OACj	OẠC
OACJ	OẠC
oacs	oác
oacS	oác
Oacs	Oác
OacS	Oác
OACs	OÁC
OACS	OÁC
oaf	oà
oaF	oà
Oaf	Oà
OaF	Oà
OAf	OÀ
OAF	OÀ
oafi	oài
oaFi	oài
Oafi	Oài
OaFi	Oài
OAfI	OÀI
OAFI	OÀI
oafn	oàn
oaFn	oàn
Oafn	Oàn
OaFn	Oàn
OAfN	OÀN
OAFN	OÀN
oafng	oàng
oaFng	oàng
Oafng	Oàng
OaFng	Oàng
OAfNG	OÀNG
OAFNG	OÀNG
oafnh	oành
oaFnh	oành
Oafnh	Oành
OaFnh	Oành
OAfNH	OÀNH
OAFNH	OÀNH
oafy	oày
oaFy	oày
Oafy	Oày
OaFy	Oày
OAfY	OÀY
OAFY	OÀY
oai	oai
Oai	Oai
OAI	OAI
oaif	oài
oaiF	oài
Oaif	Oài
OaiF	Oài
OAIf	OÀI
OAIF	OÀI
oaij	oại
oaiJ	oại
Oaij	Oại
OaiJ	Oại
OAIj	OẠI
OAIJ	OẠI
oair	oải
oaiR	oải
Oair	Oải
OaiR	Oải
OAIr	OẢI
OAIR	OẢI
oais	oái
oaiS	oái
Oais	Oái
OaiS	Oái
OAIs	OÁI
OAIS	OÁI
oaix	oãi
oaiX	oãi
Oaix	Oãi
OaiX	Oãi
OAIx	OÃI
OAIX	OÃI
oaj	oạ
oaJ	oạ
Oaj	Oạ
OaJ	Oạ
OAj	OẠ
OAJ	OẠ
oajc	oạc
oaJc	oạc
Oajc	Oạc
OaJc	Oạc
OAjC	OẠC
OAJC	OẠC
oajch	oạch
oaJch	oạch
Oajch	Oạch
OaJch	Oạch
OAjCH	OẠCH
OAJCH	OẠCH
oaji	oại
oaJi	oại
Oaji	Oại
OaJi	Oại
OAjI	OẠI
OAJI	OẠI
oajn	oạn
oaJn	oạn
Oajn	Oạn
OaJn	Oạn
OAjN	OẠN
OAJN	OẠN
oajng	oạng
oaJng	oạng
Oajng	Oạng
OaJng	Oạng
OAjNG	OẠNG
OAJNG	OẠNG
oajnh	oạnh
oaJnh	oạnh
Oajnh	Oạnh
OaJnh	Oạnh
OAjNH	OẠNH
OAJNH	OẠNH
oajp	oạp
oaJp	oạp
Oajp	Oạp
OaJp	Oạp
OAjP	OẠP
OAJP	OẠP
oajt	oạt
oaJt	oạt
Oajt	Oạt
OaJt	Oạt
OAjT	OẠT
OAJT	OẠT
oajy	oạy
oaJy	oạy
Oajy	Oạy
OaJy	Oạy
OAjY	OẠY
OAJY	OẠY
oan	oan
Oan	Oan
OAN	OAN
oanf	oàn
oanF	oàn
Oanf	Oàn
OanF	Oàn
OANf	OÀN
OANF	OÀN
oang	oang
Oang	Oang
OANG	OANG
oangf	oàng
oangF	oàng
Oangf	Oàng
OangF	Oàng
OANGf	OÀNG
OANGF	OÀNG
oangj	oạng
oangJ	oạng
Oangj	Oạng
OangJ	Oạng
OANGj	OẠNG
OANGJ	OẠNG
oangr	oảng
oangR	oảng
Oangr	Oảng
OangR	Oảng
OANGr	OẢNG
OANGR	OẢNG
oangs	oáng
oangS	oáng
Oangs	Oáng
OangS	Oáng
OANGs	OÁNG
OANGS	OÁNG
oangx	oãng
oangX	oãng
Oangx	Oãng
OangX	Oãng
OANGx	OÃNG
OANGX	OÃNG
oanh	oanh
Oanh	Oanh
OANH	OANH
oanhf	oành
oanhF	oành
Oanhf	Oành
OanhF	Oành
OANHf	OÀNH
OANHF	OÀNH
oanhj	oạnh
oanhJ	oạnh
Oanhj	Oạnh
OanhJ	Oạnh
OANHj	OẠNH
OANHJ	OẠNH
oanhr	oảnh
oanhR	oảnh
Oanhr	Oảnh
OanhR	Oảnh
OANHr	OẢNH
OANHR	OẢNH
oanhs	oánh
oanhS	oánh
Oanhs	Oánh
OanhS	Oánh
OANHs	OÁNH
OANHS	OÁNH
oanhx	oãnh
oanhX	oãnh
Oanhx	Oãnh
OanhX	Oãnh
OANHx	OÃNH
OANHX	OÃNH
oanj	oạn
oanJ	oạn
Oanj	Oạn
OanJ	Oạn
OANj	OẠN
OANJ	OẠN
oanr	oản
oanR	oản
Oanr	Oản
OanR	Oản
OANr	OẢN
OANR	OẢN
oans	oán
oanS	oán
Oans	Oán
OanS	Oán
OANs	OÁN
OANS	OÁN
oanx	oãn
oanX	oãn
Oanx	Oãn
OanX	Oãn
OANx	OÃN
OANX	OÃN
oap	oap
Oap	Oap
OAP	OAP
oapj	oạp
oapJ	oạp
Oapj	Oạp
OapJ	Oạp
OAPj	OẠP
OAPJ	OẠP
oaps	oáp
oapS	oáp
Oaps	Oáp
OapS	Oáp
OAPs	OÁP
OAPS	OÁP
oar	oả
oaR	oả
Oar	Oả
OaR	Oả
OAr	OẢ
OAR	OẢ
oari	oải
oaRi	oải
Oari	Oải
OaRi	Oải
OArI	OẢI
OARI	OẢI
oarn	oản
oaRn	oản
Oarn	Oản
OaRn	Oản
OArN	OẢN
OARN	OẢN
oarng	oảng
oaRng	oảng
Oarng	Oảng
OaRng	Oảng
OArNG	OẢNG
OARNG	OẢNG
oarnh	oảnh
oaRnh	oảnh
Oarnh	Oảnh
OaRnh	Oảnh
OArNH	OẢNH
OARNH	OẢNH
oary	oảy
oaRy	oảy
Oary	Oảy
OaRy	Oảy
OArY	OẢY
OARY	OẢY
oas	oá
oaS	oá
Oas	Oá
OaS	Oá
OAs	OÁ
OAS	OÁ
oasc	oác
oaSc	oác
Oasc	Oác
OaSc	Oác
OAsC	OÁC
OASC	OÁC
oasch	oách
oaSch	oách
Oasch	Oách
OaSch	Oách
OAsCH	OÁCH
OASCH	OÁCH
oasi	oái
oaSi	oái
Oasi	Oái
OaSi	Oái
OAsI	OÁI
OASI	OÁI
oasn	oán
oaSn	oán
Oasn	Oán
OaSn	Oán
OAsN	OÁN
OASN	OÁN
oasng	oáng
oaSng	oáng
Oasng	Oáng
OaSng	Oáng
OAsNG	OÁNG
OASNG	OÁNG
oasnh	oánh
oaSnh	oánh
Oasnh	Oánh
OaSnh	Oánh
OAsNH	OÁNH
OASNH	OÁNH
oasp	oáp
oaSp	oáp
Oasp	Oáp
OaSp	Oáp
OAsP	OÁP
OASP	OÁP
oast	oát
oaSt	oát
Oast	Oát
OaSt	Oát
OAsT	OÁT
OAST	OÁT
oasy	oáy
oaSy	oáy
Oasy	Oáy
OaSy	Oáy
OAsY	OÁY
OASY	OÁY
oat	oat
Oat	Oat
OAT	OAT
oatj	oạt
oatJ	oạt
Oatj	Oạt
OatJ	Oạt
OATj	OẠT
OATJ	OẠT
oats	oát
oatS	oát
Oats	Oát
OatS	Oát
OATs	OÁT
OATS	OÁT
oawc	oăc
oaWc	oăc
Oawc	Oăc
OaWc	Oăc
OAwC	OĂC
OAWC	OĂC
oawcj	oặc
oaWcJ	oặc
Oawcj	Oặc
OaWcJ	Oặc
OAwCj	OẶC
OAWCJ	OẶC
oawcs	oắc
oaWcS	oắc
Oawcs	Oắc
OaWcS	Oắc
OAwCs	OẮC
OAWCS	OẮC
oawfn	oằn
oaWFn	oằn
Oawfn	Oằn
OaWFn	Oằn
OAwfN	OẰN
OAWFN	OẰN
oawjc	oặc
oaWJc	oặc
Oawjc	Oặc
OaWJc	Oặc
OAwjC	OẶC
OAWJC	OẶC
oawjn	oặn
oaWJn	oặn
Oawjn	Oặn
OaWJn	Oặn
OAwjN	OẶN
OAWJN	OẶN
oawjt	oặt
oaWJt	oặt
Oawjt	Oặt
OaWJt	Oặt
OAwjT	OẶT
OAWJT	OẶT
oawn	oăn
oaWn	oăn
Oawn	Oăn
OaWn	Oăn
OAwN	OĂN
OAWN	OĂN
oawnf	oằn
oaWnF	oằn
Oawnf	Oằn
OaWnF	Oằn
OAwNf	OẰN
OAWNF	OẰN
oawnj	oặn
oaWnJ	oặn
Oawnj	Oặn
OaWnJ	Oặn
OAwNj	OẶN
OAWNJ	OẶN
oawnr	oẳn
oaWnR	oẳn
Oawnr	Oẳn
OaWnR	Oẳn
OAwNr	OẲN
OAWNR	OẲN
oawns	oắn
oaWnS	oắn
Oawns	Oắn
OaWnS	Oắn
OAwNs	OẮN
OAWNS	OẮN
oawnx	oẵn
oaWnX	oẵn
Oawnx	Oẵn
OaWnX	Oẵn
OAwNx	OẴN
OAWNX	OẴN
oawrn	oẳn
oaWRn	oẳn
Oawrn	Oẳn
OaWRn	Oẳn
OAwrN	OẲN
OAWRN	OẲN
oawsc	oắc
oaWSc	oắc
Oawsc	Oắc
OaWSc	Oắc
OAwsC	OẮC
OAWSC	OẮC
oawsn	oắn
oaWSn	oắn
Oawsn	Oắn
OaWSn	Oắn
OAwsN	OẮN
OAWSN	OẮN
oawst	oắt
oaWSt	oắt
Oawst	Oắt
OaWSt	Oắt
OAwsT	OẮT
OAWST	OẮT
oawt	oăt
oaWt	oăt
Oawt	Oăt
OaWt	Oăt
OAwT	OĂT
OAWT	OĂT
oawtj	oặt
oaWtJ	oặt
Oawtj	Oặt
OaWtJ	Oặt
OAwTj	OẶT
OAWTJ	OẶT
oawts	oắt
oaWtS	oắt
Oawts	Oắt
OaWtS	Oắt
OAwTs	OẮT
OAWTS	OẮT
oawxn	oẵn
oaWXn	oẵn
Oawxn	Oẵn
OaWXn	Oẵn
OAwxN	OẴN
OAWXN	OẴN
oax	oã
oaX	oã
Oax	Oã
OaX	Oã
OAx	OÃ
OAX	OÃ
oaxi	oãi
oaXi	oãi
Oaxi	Oãi
OaXi	Oãi
OAxI	OÃI
OAXI	OÃI
oaxn	oãn
oaXn	oãn
Oaxn	Oãn
OaXn	Oãn
OAxN	OÃN
OAXN	OÃN
oaxng	oãng
oaXng	oãng
Oaxng	Oãng
OaXng	Oãng
OAxNG	OÃNG
OAXNG	OÃNG
oaxnh	oãnh
oaXnh	oãnh
Oaxnh	Oãnh
OaXnh	Oãnh
OAxNH	OÃNH
OAXNH	OÃNH
oaxy	oãy
oaXy	oãy
Oaxy	Oãy
OaXy	Oãy
OAxY	OÃY
OAXY	OÃY
oay	oay
Oay	Oay
OAY	OAY
oayf	oày
oayF	oày
Oayf	Oày
OayF	Oày
OAYf	OÀY
OAYF	OÀY
oayj	oạy
oayJ	oạy
Oayj	Oạy
OayJ	Oạy
OAYj	OẠY
OAYJ	OẠY
oayr	oảy
oayR	oảy
Oayr	Oảy
OayR	Oảy
OAYr	OẢY
OAYR	OẢY
oays	oáy
oayS	oáy
Oays	Oáy
OayS	Oáy
OAYs	OÁY
OAYS	OÁY
oayx	oãy
oayX	oãy
Oayx	Oãy
OayX	Oãy
OAYx	OÃY
OAYX	OÃY
oc	oc
Oc	Oc
OC	OC
ocj	ọc
ocJ	ọc
Ocj	Ọc
OcJ	Ọc
OCj	ỌC
OCJ	ỌC
ocs	óc
ocS	óc
Ocs	Óc
OcS	Óc
OCs	ÓC
OCS	ÓC
oe	oe
Oe	Oe
OE	OE
oef	oè
oeF	oè
Oef	Oè
OeF	Oè
OEf	OÈ
OEF	OÈ
oej	oẹ
oeJ	oẹ
Oej	Oẹ
OeJ	Oẹ
OEj	OẸ
OEJ	OẸ
oer	oẻ
oeR	oẻ
Oer	Oẻ
OeR	Oẻ
OEr	OẺ
OER	OẺ
oes	oé
oeS	oé
Oes	Oé
OeS	Oé
OEs	OÉ
OES	OÉ
oex	oẽ
oeX	oẽ
Oex	Oẽ
OeX	Oẽ
OEx	OẼ
OEX	OẼ
of	ò
oF	ò
Of	Ò
OF	Ò
ofi	òi
oFi	òi
Ofi	Òi
OfI	ÒI
OFi	Òi
OFI	ÒI
ofm	òm
oFm	òm
Ofm	Òm
OfM	ÒM
OFm	Òm
OFM	ÒM
ofn	òn
oFn	òn
Ofn	Òn
OfN	ÒN
OFn	Òn
OFN	ÒN
ofng	òng
oFng	òng
Ofng	Òng
OfNG	ÒNG
OFng	Òng
OFNG	ÒNG
oi	oi
Oi	Oi
OI	OI
oif	òi
oiF	òi
Oif	Òi
OiF	Òi
OIf	ÒI
OIF	ÒI
oij	ọi
oiJ	ọi
Oij	Ọi
OiJ	Ọi
OIj	ỌI
OIJ	ỌI
oir	ỏi
oiR	ỏi
Oir	Ỏi
OiR	Ỏi
OIr	ỎI
OIR	ỎI
ois	ói
oiS	ói
Ois	Ói
OiS	Ói
OIs	ÓI
OIS	ÓI
oix	õi
oiX	õi
Oix	Õi
OiX	Õi
OIx	ÕI
OIX	ÕI
oj	ọ
oJ	ọ
Oj	Ọ
OJ	Ọ
ojc	ọc
oJc	ọc
Ojc	Ọc
OjC	ỌC
OJc	Ọc
OJC	ỌC
oji	ọi
oJi	ọi
Oji	Ọi
OjI	ỌI
OJi	Ọi
OJI	ỌI
ojm	ọm
oJm	ọm
Ojm	Ọm
OjM	ỌM
OJm	Ọm
OJM	ỌM
ojn	ọn
oJn	ọn
Ojn	Ọn
OjN	ỌN
OJn	Ọn
OJN	ỌN
ojng	ọng
oJng	ọng
Ojng	Ọng
OjNG	ỌNG
OJng	Ọng
OJNG	ỌNG
ojp	ọp
oJp	ọp
Ojp	Ọp
OjP	ỌP
OJp	Ọp
OJP	ỌP
ojt	ọt
oJt	ọt
Ojt	Ọt
OjT	ỌT
OJt	Ọt
OJT	ỌT
om	om
Om	Om
OM	OM
omf	òm
omF	òm
Omf	Òm
OmF	Òm
OMf	ÒM
OMF	ÒM
omj	ọm
omJ	ọm
Omj	Ọm
OmJ	Ọm
OMj	ỌM
OMJ	ỌM
omr	ỏm
omR	ỏm
Omr	Ỏm
OmR	Ỏm
OMr	ỎM
OMR	ỎM
oms	óm
omS	óm
Oms	Óm
OmS	Óm
OMs	ÓM
OMS	ÓM
omx	õm
omX	õm
Omx	Õm
OmX	Õm
OMx	ÕM
OMX	ÕM
on	on
On	On
ON	ON
onf	òn
onF	òn
Onf	Òn
OnF	Òn
ONf	ÒN
ONF	ÒN
ong	ong
Ong	Ong
ONG	ONG
ongf	òng
ongF	òng
Ongf	Òng
OngF	Òng
ONGf	ÒNG
ONGF	ÒNG
ongj	ọng
ongJ	ọng
Ongj	Ọng
OngJ	Ọng
ONGj	ỌNG
ONGJ	ỌNG
ongr	ỏng
ongR	ỏng
Ongr	Ỏng
OngR	Ỏng
ONGr	ỎNG
ONGR	ỎNG
ongs	óng
ongS	óng
Ongs	Óng
OngS	Óng
ONGs	ÓNG
ONGS	ÓNG
ongx	õng
ongX	õng
Ongx	Õng
OngX	Õng
ONGx	ÕNG
ONGX	ÕNG
onj	ọn
onJ	ọn
Onj	Ọn
OnJ	Ọn
ONj	ỌN
ONJ	ỌN
onr	ỏn
onR	ỏn
Onr	Ỏn
OnR	Ỏn
ONr	ỎN
ONR	ỎN
ons	ón
onS	ón
Ons	Ón
OnS	Ón
ONs	ÓN
ONS	ÓN
onx	õn
onX	õn
Onx	Õn
OnX	Õn
ONx	ÕN
ONX	ÕN
oo	ô
Oo	Ô
OO	Ô
ooc	ôc
Ooc	Ôc
OoC	ÔC
OOc	Ôc
OOC	ÔC
oocj	ộc
oocJ	ộc
Oocj	Ộc
OoCj	ỘC
OOcJ	Ộc
OOCJ	ỘC
oocs	ốc
oocS	ốc
Oocs	Ốc
OoCs	ỐC
OOcS	Ốc
OOCS	ỐC
oof	ồ
ooF	ồ
Oof	Ồ
OOF	Ồ
oofi	ồi
ooFi	ồi
Oofi	Ồi
OofI	ỒI
OOFi	Ồi
OOFI	ỒI
oofm	ồm
ooFm	ồm
Oofm	Ồm
OofM	ỒM
OOFm	Ồm
OOFM	ỒM
oofn	ồn
ooFn	ồn
Oofn	Ồn
OofN	ỒN
OOFn	Ồn
OOFN	ỒN
oofng	ồng
ooFng	ồng
Oofng	Ồng
OofNG	ỒNG
OOFng	Ồng
OOFNG	ỒNG
ooi	ôi
Ooi	Ôi
OoI	ÔI
OOi	Ôi
OOI	ÔI
ooif	ồi
ooiF	ồi
Ooif	Ồi
OoIf	ỒI
OOiF	Ồi
OOIF	ỒI
ooij	ội
ooiJ	ội
Ooij	Ội
OoIj	ỘI
OOiJ	Ội
OOIJ	ỘI
ooir	ổi
ooiR	ổi
Ooir	Ổi
OoIr	ỔI
OOiR	Ổi
OOIR	ỔI
oois	ối
ooiS	ối
Oois	Ối
OoIs	ỐI
OOiS	Ối
OOIS	ỐI
ooix	ỗi
ooiX	ỗi
Ooix	Ỗi
OoIx	ỖI
OOiX	Ỗi
OOIX	ỖI
ooj	ộ
ooJ	ộ
Ooj	Ộ
OOJ	Ộ
oojc	ộc
ooJc	ộc
Oojc	Ộc
OojC	ỘC
OOJc	Ộc
OOJC	ỘC
ooji	ội
ooJi	ội
Ooji	Ội
OojI	ỘI
OOJi	Ội
OOJI	ỘI
oojm	ộm
ooJm	ộm
Oojm	Ộm
OojM	ỘM
OOJm	Ộm
OOJM	ỘM
oojn	ộn
ooJn	ộn
Oojn	Ộn
OojN	ỘN
OOJn	Ộn
OOJN	ỘN
oojng	ộng
ooJng	ộng
Oojng	Ộng
OojNG	ỘNG
OOJng	Ộng
OOJNG	ỘNG
oojp	ộp
ooJp	ộp
Oojp	Ộp
OojP	ỘP
OOJp	Ộp
OOJP	ỘP
oojt	ột
ooJt	ột
Oojt	Ột
OojT	ỘT
OOJt	Ột
OOJT	ỘT
oom	ôm
Oom	Ôm
OoM	ÔM
OOm	Ôm
OOM	ÔM
oomf	ồm
oomF	ồm
Oomf	Ồm
OoMf	ỒM
OOmF	Ồm
OOMF	ỒM
oomj	ộm
oomJ	ộm
Oomj	Ộm
OoMj	ỘM
OOmJ	Ộm
OOMJ	ỘM
oomr	ổm
oomR	ổm
Oomr	Ổm
OoMr	ỔM
OOmR	Ổm
OOMR	ỔM
ooms	ốm
oomS	ốm
Ooms	Ốm
OoMs	ỐM
OOmS	Ốm
OOMS	ỐM
oomx	ỗm
oomX	ỗm
Oomx	Ỗm
OoMx	ỖM
OOmX	Ỗm
OOMX	ỖM
oon	ôn
Oon	Ôn
OoN	ÔN
OOn	Ôn
OON	ÔN
oonf	ồn
oonF	ồn
Oonf	Ồn
OoNf	ỒN
OOnF	Ồn
OONF	ỒN
oong	ông
Oong	Ông
OoNG	ÔNG
OOng	Ông
OONG	ÔNG
oongf	ồng
oongF	ồng
Oongf	Ồng
OoNGf	ỒNG
OOngF	Ồng
OONGF	ỒNG
oongj	ộng
oongJ	ộng
Oongj	Ộng
OoNGj	ỘNG
OOngJ	Ộng
OONGJ	ỘNG
oongr	ổng
oongR	ổng
Oongr	Ổng
OoNGr	ỔNG
OOngR	Ổng
OONGR	ỔNG
oongs	ống
oongS	ống
Oongs	Ống
OoNGs	ỐNG
OOngS	Ống
OONGS	ỐNG
oongx	ỗng
oongX	ỗng
Oongx	Ỗng
OoNGx	ỖNG
OOngX	Ỗng
OONGX	ỖNG
oonj	ộn
oonJ	ộn
Oonj	Ộn
OoNj	ỘN
OOnJ	Ộn
OONJ	ỘN
oonr	ổn
oonR	ổn
Oonr	Ổn
OoNr	ỔN
OOnR	Ổn
OONR	ỔN
oons	ốn
oonS	ốn
Oons	Ốn
OoNs	ỐN
OOnS	Ốn
OONS	ỐN
oonx	ỗn
oonX	ỗn
Oonx	Ỗn
OoNx	ỖN
OOnX	Ỗn
OONX	ỖN
oop	ôp
Oop	Ôp
OoP	ÔP
OOp	Ôp
OOP	ÔP
oopj	ộp
oopJ	ộp
Oopj	Ộp
OoPj	ỘP
OOpJ	Ộp
OOPJ	ỘP
oops	ốp
oopS	ốp
Oops	Ốp
OoPs	ỐP
OOpS	Ốp
OOPS	ỐP
oor	ổ
ooR	ổ
Oor	Ổ
OOR	Ổ
oori	ổi
ooRi	ổi
Oori	Ổi
OorI	ỔI
OORi	Ổi
OORI	ỔI
oorm	ổm
ooRm	ổm
Oorm	Ổm
OorM	ỔM
OORm	Ổm
OORM	ỔM
oorn	ổn
ooRn	ổn
Oorn	Ổn
OorN	ỔN
OORn	Ổn
OORN	ỔN
oorng	ổng
ooRng	ổng
Oorng	Ổng
OorNG	ỔNG
OORng	Ổng
OORNG	ỔNG
oos	ố
ooS	ố
Oos	Ố
OOS	Ố
oosc	ốc
ooSc	ốc
Oosc	Ốc
OosC	ỐC
OOSc	Ốc
OOSC	ỐC
oosi	ối
ooSi	ối
Oosi	Ối
OosI	ỐI
OOSi	Ối
OOSI	ỐI
oosm	ốm
ooSm	ốm
Oosm	Ốm
OosM	ỐM
OOSm	Ốm
OOSM	ỐM
oosn	ốn
ooSn	ốn
Oosn	Ốn
OosN	ỐN
OOSn	Ốn
OOSN	ỐN
oosng	ống
ooSng	ống
Oosng	Ống
OosNG	ỐNG
OOSng	Ống
OOSNG	ỐNG
oosp	ốp
ooSp	ốp
Oosp	Ốp
OosP	ỐP
OOSp	Ốp
OOSP	ỐP
oost	ốt
ooSt	ốt
Oost	Ốt
OosT	ỐT
OOSt	Ốt
OOST	ỐT
oot	ôt
Oot	Ôt
OoT	ÔT
OOt	Ôt
OOT	ÔT
ootj	ột
ootJ	ột
Ootj	Ột
OoTj	ỘT
OOtJ	Ột
OOTJ	ỘT
oots	ốt
ootS	ốt
Oots	Ốt
OoTs	ỐT
OOtS	Ốt
OOTS	ỐT
oox	ỗ
ooX	ỗ
Oox	Ỗ
OOX	Ỗ
ooxi	ỗi
ooXi	ỗi
Ooxi	Ỗi
OoxI	ỖI
OOXi	Ỗi
OOXI	ỖI
ooxm	ỗm
ooXm	ỗm
Ooxm	Ỗm
OoxM	ỖM
OOXm	Ỗm
OOXM	ỖM
ooxn	ỗn
ooXn	ỗn
Ooxn	Ỗn
OoxN	ỖN
OOXn	Ỗn
OOXN	ỖN
ooxng	ỗng
ooXng	ỗng
Ooxng	Ỗng
OoxNG	ỖNG
OOXng	Ỗng
OOXNG	ỖNG
op	op
Op	Op
OP	OP
opj	ọp
opJ	ọp
Opj	Ọp
OpJ	Ọp
OPj	ỌP
OPJ	ỌP
ops	óp
opS	óp
Ops	Óp
OpS	Óp
OPs	ÓP
OPS	ÓP
or	ỏ
oR	ỏ
Or	Ỏ
OR	Ỏ
ori	ỏi
oRi	ỏi
Ori	Ỏi
OrI	ỎI
ORi	Ỏi
ORI	ỎI
orm	ỏm
oRm	ỏm
Orm	Ỏm
OrM	ỎM
ORm	Ỏm
ORM	ỎM
orn	ỏn
oRn	ỏn
Orn	Ỏn
OrN	ỎN
ORn	Ỏn
ORN	ỎN
orng	ỏng
oRng	ỏng
Orng	Ỏng
OrNG	ỎNG
ORng	Ỏng
ORNG	ỎNG
os	ó
oS	ó
Os	Ó
OS	Ó
osc	óc
oSc	óc
Osc	Óc
OsC	ÓC
OSc	Óc
OSC	ÓC
osi	ói
oSi	ói
Osi	Ói
OsI	ÓI
OSi	Ói
OSI	ÓI
osm	óm
oSm	óm
Osm	Óm
OsM	ÓM
OSm	Óm
OSM	ÓM
osn	ón
oSn	ón
Osn	Ón
OsN	ÓN
OSn	Ón
OSN	ÓN
osng	óng
oSng	óng
Osng	Óng
OsNG	ÓNG
OSng	Óng
OSNG	ÓNG
osp	óp
oSp	óp
Osp	Óp
OsP	ÓP
OSp	Óp
OSP	ÓP
ost	ót
oSt	ót
Ost	Ót
OsT	ÓT
OSt	Ót
OST	ÓT
ot	ot
Ot	Ot
OT	OT
otj	ọt
otJ	ọt
Otj	Ọt
OtJ	Ọt
OTj	ỌT
OTJ	ỌT
ots	ót
otS	ót
Ots	Ót
OtS	Ót
OTs	ÓT
OTS	ÓT
ow	ơ
oW	ơ
Ow	Ơ
OW	Ơ
owf	ờ
oWF	ờ
Owf	Ờ
OWF	Ờ
owfi	ời
oWFi	ời
Owfi	Ời
OwfI	ỜI
OWFi	Ời
OWFI	ỜI
owfm	ờm
oWFm	ờm
Owfm	Ờm
OwfM	ỜM
OWFm	Ờm
OWFM	ỜM
owfn	ờn
oWFn	ờn
Owfn	Ờn
OwfN	ỜN
OWFn	Ờn
OWFN	ỜN
owi	ơi
oWi	ơi
Owi	Ơi
OwI	ƠI
OWi	Ơi
OWI	ƠI
owif	ời
oWiF	ời
Owif	Ời
OwIf	ỜI
OWiF	Ời
OWIF	ỜI
owij	ợi
oWiJ	ợi
Owij	Ợi
OwIj	ỢI
OWiJ	Ợi
OWIJ	ỢI
owir	ởi
oWiR	ởi
Owir	Ởi
OwIr	ỞI
OWiR	Ởi
OWIR	ỞI
owis	ới
oWiS	ới
Owis	Ới
OwIs	ỚI
OWiS	Ới
OWIS	ỚI
owix	ỡi
oWiX	ỡi
Owix	Ỡi
OwIx	ỠI
OWiX	Ỡi
OWIX	ỠI
owj	ợ
oWJ	ợ
Owj	Ợ
OWJ	Ợ
owji	ợi
oWJi	ợi
Owji	Ợi
OwjI	ỢI
OWJi	Ợi
OWJI	ỢI
owjm	ợm
oWJm	ợm
Owjm	Ợm
OwjM	ỢM
OWJm	Ợm
OWJM	ỢM
owjn	ợn
oWJn	ợn
Owjn	Ợn
OwjN	ỢN
OWJn	Ợn
OWJN	ỢN
owjp	ợp
oWJp	ợp
Owjp	Ợp
OwjP	ỢP
OWJp	Ợp
OWJP	ỢP
owjt	ợt
oWJt	ợt
Owjt	Ợt
OwjT	ỢT
OWJt	Ợt
OWJT	ỢT
owm	ơm
oWm	ơm
Owm	Ơm
OwM	ƠM
OWm	Ơm
OWM	ƠM
owmf	ờm
oWmF	ờm
Owmf	Ờm
OwMf	ỜM
OWmF	Ờm
OWMF	ỜM
owmj	ợm
oWmJ	ợm
Owmj	Ợm
OwMj	ỢM
OWmJ	Ợm
OWMJ	ỢM
owmr	ởm
oWmR	ởm
Owmr	Ởm
OwMr	ỞM
OWmR	Ởm
OWMR	ỞM
owms	ớm
oWmS	ớm
Owms	Ớm
OwMs	ỚM
OWmS	Ớm
OWMS	ỚM
owmx	ỡm
oWmX	ỡm
Owmx	Ỡm
OwMx	ỠM
OWmX	Ỡm
OWMX	ỠM
own	ơn
oWn	ơn
Own	Ơn
OwN	ƠN
OWn	Ơn
OWN	ƠN
ownf	ờn
oWnF	ờn
Ownf	Ờn
OwNf	ỜN
OWnF	Ờn
OWNF	ỜN
ownj	ợn
oWnJ	ợn
Ownj	Ợn
OwNj	ỢN
OWnJ	Ợn
OWNJ	ỢN
ownr	ởn
oWnR	ởn
Ownr	Ởn
OwNr	ỞN
OWnR	Ởn
OWNR	ỞN
owns	ớn
oWnS	ớn
Owns	Ớn
OwNs	ỚN
OWnS	Ớn
OWNS	ỚN
ownx	ỡn
oWnX	ỡn
Ownx	Ỡn
OwNx	ỠN
OWnX	Ỡn
OWNX	ỠN
owp	ơp
oWp	ơp
Owp	Ơp
OwP	ƠP
OWp	Ơp
OWP	ƠP
owpj	ợp
oWpJ	ợp
Owpj	Ợp
OwPj	ỢP
OWpJ	Ợp
OWPJ	ỢP
owps	ớp
oWpS	ớp
Owps	Ớp
OwPs	ỚP
OWpS	Ớp
OWPS	ỚP
owr	ở
oWR	ở
Owr	Ở
OWR	Ở
owri	ởi
oWRi	ởi
Owri	Ởi
OwrI	ỞI
OWRi	Ởi
OWRI	ỞI
owrm	ởm
oWRm	ởm
Owrm	Ởm
OwrM	ỞM
OWRm	Ởm
OWRM	ỞM
owrn	ởn
oWRn	ởn
Owrn	Ởn
OwrN	ỞN
OWRn	Ởn
OWRN	ỞN
ows	ớ
oWS	ớ
Ows	Ớ
OWS	Ớ
owsi	ới
oWSi	ới
Owsi	Ới
OwsI	ỚI
OWSi	Ới
OWSI	ỚI
owsm	ớm
oWSm	ớm
Owsm	Ớm
OwsM	ỚM
OWSm	Ớm
OWSM	ỚM
owsn	ớn
oWSn	ớn
Owsn	Ớn
OwsN	ỚN
OWSn	Ớn
OWSN	ỚN
owsp	ớp
oWSp	ớp
Owsp	Ớp
OwsP	ỚP
OWSp	Ớp
OWSP	ỚP
owst	ớt
oWSt	ớt
Owst	Ớt
OwsT	ỚT
OWSt	Ớt
OWST	ỚT
owt	ơt
oWt	ơt
Owt	Ơt
OwT	ƠT
OWt	Ơt
OWT	ƠT
owtj	ợt
oWtJ	ợt
Owtj	Ợt
OwTj	ỢT
OWtJ	Ợt
OWTJ	ỢT
owts	ớt
oWtS	ớt
Owts	Ớt
OwTs	ỚT
OWtS	Ớt
OWTS	ỚT
owx	ỡ
oWX	ỡ
Owx	Ỡ
OWX	Ỡ
owxi	ỡi
oWXi	ỡi
Owxi	Ỡi
OwxI	ỠI
OWXi	Ỡi
OWXI	ỠI
owxm	ỡm
oWXm	ỡm
Owxm	Ỡm
OwxM	ỠM
OWXm	Ỡm
OWXM	ỠM
owxn	ỡn
oWXn	ỡn
Owxn	Ỡn
OwxN	ỠN
OWXn	Ỡn
OWXN	ỠN
ox	õ
oX	õ
Ox	Õ
OX	Õ
oxi	õi
oXi	õi
Oxi	Õi
OxI	ÕI
OXi	Õi
OXI	ÕI
oxm	õm
oXm	õm
Oxm	Õm
OxM	ÕM
OXm	Õm
OXM	ÕM
oxn	õn
oXn	õn
Oxn	Õn
OxN	ÕN
OXn	Õn
OXN	ÕN
oxng	õng
oXng	õng
Oxng	Õng
OxNG	ÕNG
OXng	Õng
OXNG	ÕNG
u	u
U	U
ua	ua
Ua	Ua
UA	UA
uaafn	uần
uaaFn	uần
Uaafn	Uần
UaaFn	Uần
UAafN	UẦN
UAAFN	UẦN
uaafng	uầng
uaaFng	uầng
Uaafng	Uầng
UaaFng	Uầng
UAafNG	UẦNG
UAAFNG	UẦNG
uaajn	uận
uaaJn	uận
Uaajn	Uận
UaaJn	Uận
UAajN	UẬN
UAAJN	UẬN
uaajng	uậng
uaaJng	uậng
Uaajng	Uậng
UaaJng	Uậng
UAajNG	UẬNG
UAAJNG	UẬNG
uaajt	uật
uaaJt	uật
Uaajt	Uật
UaaJt	Uật
UAajT	UẬT
UAAJT	UẬT
uaan	uân
Uaan	Uân
UAaN	UÂN
UAAN	UÂN
uaanf	uần
uaanF	uần
Uaanf	Uần
UaanF	Uần
UAaNf	UẦN
UAANF	UẦN
uaang	uâng
Uaang	Uâng
UAaNG	UÂNG
UAANG	UÂNG
uaangf	uầng
uaangF	uầng
Uaangf	Uầng
UaangF	Uầng
UAaNGf	UẦNG
UAANGF	UẦNG
uaangj	uậng
uaangJ	uậng
Uaangj	Uậng
UaangJ	Uậng
UAaNGj	UẬNG
UAANGJ	UẬNG
uaangr	uẩng
uaangR	uẩng
Uaangr	Uẩng
UaangR	Uẩng
UAaNGr	UẨNG
UAANGR	UẨNG
uaangs	uấng
uaangS	uấng
Uaangs	Uấng
UaangS	Uấng
UAaNGs	UẤNG
UAANGS	UẤNG
uaangx	uẫng
uaangX	uẫng
Uaangx	Uẫng
UaangX	Uẫng
UAaNGx	UẪNG
UAANGX	UẪNG
uaanj	uận
uaanJ	uận
Uaanj	Uận
UaanJ	Uận
UAaNj	UẬN
UAANJ	UẬN
uaanr	uẩn
uaanR	uẩn
Uaanr	Uẩn
UaanR	Uẩn
UAaNr	UẨN
UAANR	UẨN
uaans	uấn
uaanS	uấn
Uaans	Uấn
UaanS	Uấn
UAaNs	UẤN
UAANS	UẤN
uaanx	uẫn
uaanX	uẫn
Uaanx	Uẫn
UaanX	Uẫn
UAaNx	UẪN
UAANX	UẪN
uaarn	uẩn
uaaRn	uẩn
Uaarn	Uẩn
UaaRn	Uẩn
UAarN	UẨN
UAARN	UẨN
uaarng	uẩng
uaaRng	uẩng
Uaarng	Uẩng
UaaRng	Uẩng
UAarNG	UẨNG
UAARNG	UẨNG
uaasn	uấn
uaaSn	uấn
Uaasn	Uấn
UaaSn	Uấn
UAasN	UẤN
UAASN	UẤN
uaasng	uấng
uaaSng	uấng
Uaasng	Uấng
UaaSng	Uấng
UAasNG	UẤNG
UAASNG	UẤNG
uaast	uất
uaaSt	uất
Uaast	Uất
UaaSt	Uất
UAasT	UẤT
UAAST	UẤT
uaat	uât
Uaat	Uât
UAaT	UÂT
UAAT	UÂT
uaatj	uật
uaatJ	uật
Uaatj	Uật
UaatJ	Uật
UAaTj	UẬT
UAATJ	UẬT
uaats	uất
uaatS	uất
Uaats	Uất
UaatS	Uất
UAaTs	UẤT
UAATS	UẤT
uaaxn	uẫn
uaaXn	uẫn
Uaaxn	Uẫn
UaaXn	Uẫn
UAaxN	UẪN
UAAXN	UẪN
uaaxng	uẫng
uaaXng	uẫng
Uaaxng	Uẫng
UaaXng	Uẫng
UAaxNG	UẪNG
UAAXNG	UẪNG
uaf	ùa
uaF	ùa
Uaf	Ùa
UaF	Ùa
UAf	ÙA
UAF	ÙA
uaj	ụa
uaJ	ụa
Uaj	Ụa
UaJ	Ụa
UAj	ỤA
UAJ	ỤA
uar	ủa
uaR	ủa
Uar	Ủa
UaR	Ủa
UAr	ỦA
UAR	ỦA
uas	úa
uaS	úa
Uas	Úa
UaS	Úa
UAs	ÚA
UAS	ÚA
uax	ũa
uaX	ũa
Uax	Ũa
UaX	Ũa
UAx	ŨA
UAX	ŨA
uc	uc
Uc	Uc
UC	UC
ucj	ục
ucJ	ục
Ucj	Ục
UcJ	Ục
UCj	ỤC
UCJ	ỤC
ucs	úc
ucS	úc
Ucs	Úc
UcS	Úc
UCs	ÚC
UCS	ÚC
uee	uê
Uee	Uê
UEe	UÊ
UEE	UÊ
ueef	uề
ueeF	uề
Ueef	Uề
UeeF	Uề
UEef	UỀ
UEEF	UỀ
ueej	uệ
ueeJ	uệ
Ueej	Uệ
UeeJ	Uệ
UEej	UỆ
UEEJ	UỆ
ueer	uể
ueeR	uể
Ueer	Uể
UeeR	Uể
UEer	UỂ
UEER	UỂ
uees	uế
ueeS	uế
Uees	Uế
UeeS	Uế
UEes	UẾ
UEES	UẾ
ueex	uễ
ueeX	uễ
Ueex	Uễ
UeeX	Uễ
UEex	UỄ
UEEX	UỄ
uf	ù
uF	ù
Uf	Ù
UF	Ù
ufa	ùa
uFa	ùa
Ufa	Ùa
UfA	ÙA
UFa	Ùa
UFA	ÙA
ufi	ùi
uFi	ùi
Ufi	Ùi
UfI	ÙI
UFi	Ùi
UFI	ÙI
ufm	ùm
uFm	ùm
Ufm	Ùm
UfM	ÙM
UFm	Ùm
UFM	ÙM
ufn	ùn
uFn	ùn
Ufn	Ùn
UfN	ÙN
UFn	Ùn
UFN	ÙN
ufng	ùng
uFng	ùng
Ufng	Ùng
UfNG	ÙNG
UFng	Ùng
UFNG	ÙNG
ui	ui
Ui	Ui
UI	UI
uif	ùi
uiF	ùi
Uif	Ùi
UiF	Ùi
UIf	ÙI
UIF	ÙI
uij	ụi
uiJ	ụi
Uij	Ụi
UiJ	Ụi
UIj	ỤI
UIJ	ỤI
uir	ủi
uiR	ủi
Uir	Ủi
UiR	Ủi
UIr	ỦI
UIR	ỦI
uis	úi
uiS	úi
Uis	Úi
UiS	Úi
UIs	ÚI
UIS	ÚI
uix	ũi
uiX	ũi
Uix	Ũi
UiX	Ũi
UIx	ŨI
UIX	ŨI
uj	ụ
uJ	ụ
Uj	Ụ
UJ	Ụ
uja	ụa
uJa	ụa
Uja	Ụa
UjA	ỤA
UJa	Ụa
UJA	ỤA
ujc	ục
uJc	ục
Ujc	Ục
UjC	ỤC
UJc	Ục
UJC	ỤC
uji	ụi
uJi	ụi
Uji	Ụi
UjI	ỤI
UJi	Ụi
UJI	ỤI
ujm	ụm
uJm	ụm
Ujm	Ụm
UjM	ỤM
UJm	Ụm
UJM	ỤM
ujn	ụn
uJn	ụn
Ujn	Ụn
UjN	ỤN
UJn	Ụn
UJN	ỤN
ujng	ụng
uJng	ụng
Ujng	Ụng
UjNG	ỤNG
UJng	Ụng
UJNG	ỤNG
ujp	ụp
uJp	ụp
Ujp	Ụp
UjP	ỤP
UJp	Ụp
UJP	ỤP
ujt	ụt
uJt	ụt
Ujt	Ụt
UjT	ỤT
UJt	Ụt
UJT	ỤT
um	um
Um	Um
UM	UM
umf	ùm
umF	ùm
Umf	Ùm
UmF	Ùm
UMf	ÙM
UMF	ÙM
umj	ụm
umJ	ụm
Umj	Ụm
UmJ	Ụm
UMj	ỤM
UMJ	ỤM
umr	ủm
umR	ủm
Umr	Ủm
UmR	Ủm
UMr	ỦM
UMR	ỦM
ums	úm
umS	úm
Ums	Úm
UmS	Úm
UMs	ÚM
UMS	ÚM
umx	ũm
umX	ũm
Umx	Ũm
UmX	Ũm
UMx	ŨM
UMX	ŨM
un	un
Un	Un
UN	UN
unf	ùn
unF	ùn
Unf	Ùn
UnF	Ùn
UNf	ÙN
UNF	ÙN
ung	ung
Ung	Ung
UNG	UNG
ungf	ùng
ungF	ùng
Ungf	Ùng
UngF	Ùng
UNGf	ÙNG
UNGF	ÙNG
ungj	ụng
ungJ	ụng
Ungj	Ụng
UngJ	Ụng
UNGj	ỤNG
UNGJ	ỤNG
ungr	ủng
ungR	ủng
Ungr	Ủng
UngR	Ủng
UNGr	ỦNG
UNGR	ỦNG
ungs	úng
ungS	úng
Ungs	Úng
UngS	Úng
UNGs	ÚNG
UNGS	ÚNG
ungx	ũng
ungX	ũng
Ungx	Ũng
UngX	Ũng
UNGx	ŨNG
UNGX	ŨNG
unj	ụn
unJ	ụn
Unj	Ụn
UnJ	Ụn
UNj	ỤN
UNJ	ỤN
unr	ủn
unR	ủn
Unr	Ủn
UnR	Ủn
UNr	ỦN
UNR	ỦN
uns	ún
unS	ún
Uns	Ún
UnS	Ún
UNs	ÚN
UNS	ÚN
unx	ũn
unX	ũn
Unx	Ũn
UnX	Ũn
UNx	ŨN
UNX	ŨN
uooc	uôc
Uooc	Uôc
UOoC	UÔC
UOOC	UÔC
uoocj	uộc
uoocJ	uộc
Uoocj	Uộc
UoocJ	Uộc
UOoCj	UỘC
UOOCJ	UỘC
uoocs	uốc
uoocS	uốc
Uoocs	Uốc
UoocS	Uốc
UOoCs	UỐC
UOOCS	UỐC
uoofi	uồi
uooFi	uồi
Uoofi	Uồi
UooFi	Uồi
UOofI	UỒI
UOOFI	UỒI
uoofm	uồm
uooFm	uồm
Uoofm	Uồm
UooFm	Uồm
UOofM	UỒM
UOOFM	UỒM
uoofn	uồn
uooFn	uồn
Uoofn	Uồn
UooFn	Uồn
UOofN	UỒN
UOOFN	UỒN
uoofng	uồng
uooFng	uồng
Uoofng	Uồng
UooFng	Uồng
UOofNG	UỒNG
UOOFNG	UỒNG
uooi	uôi
Uooi	Uôi
UOoI	UÔI
UOOI	UÔI
uooif	uồi
uooiF	uồi
Uooif	Uồi
UooiF	Uồi
UOoIf	UỒI
UOOIF	UỒI
uooij	uội
uooiJ	uội
Uooij	Uội
UooiJ	Uội
UOoIj	UỘI
UOOIJ	UỘI
uooir	uổi
uooiR	uổi
Uooir	Uổi
UooiR	Uổi
UOoIr	UỔI
UOOIR	UỔI
uoois	uối
uooiS	uối
Uoois	Uối
UooiS	Uối
UOoIs	UỐI
UOOIS	UỐI
uooix	uỗi
uooiX	uỗi
Uooix	Uỗi
UooiX	Uỗi
UOoIx	UỖI
UOOIX	UỖI
uoojc	uộc
uooJc	uộc
Uoojc	Uộc
UooJc	Uộc
UOojC	UỘC
UOOJC	UỘC
uooji	uội
uooJi	uội
Uooji	Uội
UooJi	Uội
UOojI	UỘI
UOOJI	UỘI
uoojm	uộm
uooJm	uộm
Uoojm	Uộm
UooJm	Uộm
UOojM	UỘM
UOOJM	UỘM
uoojn	uộn
uooJn	uộn
Uoojn	Uộn
UooJn	Uộn
UOojN	UỘN
UOOJN	UỘN
uoojng	uộng
uooJng	uộng
Uoojng	Uộng
UooJng	Uộng
UOojNG	UỘNG
UOOJNG	UỘNG
uoojt	uột
uooJt	uột
Uoojt	Uột
UooJt	Uột
UOojT	UỘT
UOOJT	UỘT
uoom	uôm
Uoom	Uôm
UOoM	UÔM
UOOM	UÔM
uoomf	uồm
uoomF	uồm
Uoomf	Uồm
UoomF	Uồm
UOoMf	UỒM
UOOMF	UỒM
uoomj	uộm
uoomJ	uộm
Uoomj	Uộm
UoomJ	Uộm
UOoMj	UỘM
UOOMJ	UỘM
uoomr	uổm
uoomR	uổm
Uoomr	Uổm
UoomR	Uổm
UOoMr	UỔM
UOOMR	UỔM
uooms	uốm
uoomS	uốm
Uooms	Uốm
UoomS	Uốm
UOoMs	UỐM
UOOMS	UỐM
uoomx	uỗm
uoomX	uỗm
Uoomx	Uỗm
UoomX	Uỗm
UOoMx	UỖM
UOOMX	UỖM
uoon	uôn
Uoon	Uôn
UOoN	UÔN
UOON	UÔN
uoonf	uồn
uoonF	uồn
Uoonf	Uồn
UoonF	Uồn
UOoNf	UỒN
UOONF	UỒN
uoong	uông
Uoong	Uông
UOoNG	UÔNG
UOONG	UÔNG
uoongf	uồng
uoongF	uồng
Uoongf	Uồng
UoongF	Uồng
UOoNGf	UỒNG
UOONGF	UỒNG
uoongj	uộng
uoongJ	uộng
Uoongj	Uộng
UoongJ	Uộng
UOoNGj	UỘNG
UOONGJ	UỘNG
uoongr	uổng
uoongR	uổng
Uoongr	Uổng
UoongR	Uổng
UOoNGr	UỔNG
UOONGR	UỔNG
uoongs	uống
uoongS	uống
Uoongs	Uống
UoongS	Uống
UOoNGs	UỐNG
UOONGS	UỐNG
uoongx	uỗng
uoongX	uỗng
Uoongx	Uỗng
UoongX	Uỗng
UOoNGx	UỖNG
UOONGX	UỖNG
uoonj	uộn
uoonJ	uộn
Uoonj	Uộn
UoonJ	Uộn
UOoNj	UỘN
UOONJ	UỘN
uoonr	uổn
uoonR	uổn
Uoonr	Uổn
UoonR	Uổn
UOoNr	UỔN
UOONR	UỔN
uoons	uốn
uoonS	uốn
Uoons	Uốn
UoonS	Uốn
UOoNs	UỐN
UOONS	UỐN
uoonx	uỗn
uoonX	uỗn
Uoonx	Uỗn
UoonX	Uỗn
UOoNx	UỖN
UOONX	UỖN
uoori	uổi
uooRi	uổi
Uoori	Uổi
UooRi	Uổi
UOorI	UỔI
UOORI	UỔI
uoorm	uổm
uooRm	uổm
Uoorm	Uổm
UooRm	Uổm
UOorM	UỔM
UOORM	UỔM
uoorn	uổn
uooRn	uổn
Uoorn	Uổn
UooRn	Uổn
UOorN	UỔN
UOORN	UỔN
uoorng	uổng
uooRng	uổng
Uoorng	Uổng
UooRng	Uổng
UOorNG	UỔNG
UOORNG	UỔNG
uoosc	uốc
uooSc	uốc
Uoosc	Uốc
UooSc	Uốc
UOosC	UỐC
UOOSC	UỐC
uoosi	uối
uooSi	uối
Uoosi	Uối
UooSi	Uối
UOosI	UỐI
UOOSI	UỐI
uoosm	uốm
uooSm	uốm
Uoosm	Uốm
UooSm	Uốm
UOosM	UỐM
UOOSM	UỐM
uoosn	uốn
uooSn	uốn
Uoosn	Uốn
UooSn	Uốn
UOosN	UỐN
UOOSN	UỐN
uoosng	uống
uooSng	uống
Uoosng	Uống
UooSng	Uống
UOosNG	UỐNG
UOOSNG	UỐNG
uoost	uốt
uooSt	uốt
Uoost	Uốt
UooSt	Uốt
UOosT	UỐT
UOOST	UỐT
uoot	uôt
Uoot	Uôt
UOoT	UÔT
UOOT	UÔT
uootj	uột
uootJ	uột
Uootj	Uột
UootJ	Uột
UOoTj	UỘT
UOOTJ	UỘT
uoots	uốt
uootS	uốt
Uoots	Uốt
UootS	Uốt
UOoTs	UỐT
UOOTS	UỐT
uooxi	uỗi
uooXi	uỗi
Uooxi	Uỗi
UooXi	Uỗi
UOoxI	UỖI
UOOXI	UỖI
uooxm	uỗm
uooXm	uỗm
Uooxm	Uỗm
UooXm	Uỗm
UOoxM	UỖM
UOOXM	UỖM
uooxn	uỗn
uooXn	uỗn
Uooxn	Uỗn
UooXn	Uỗn
UOoxN	UỖN
UOOXN	UỖN
uooxng	uỗng
uooXng	uỗng
Uooxng	Uỗng
UooXng	Uỗng
UOoxNG	UỖNG
UOOXNG	UỖNG
uow	ươ
uoW	ươ
Uow	Ươ
UoW	Ươ
UOw	ƯƠ
UOW	ƯƠ
uowc	ươc
uoWc	ươc
uowcj	ược
uoWcJ	ược
uowcs	ước
uoWcS	ước
uowf	ườ
uoWF	ườ
Uowf	Ườ
UoWF	Ườ
UOwf	ƯỜ
UOWF	ƯỜ
uowfi	ười
uoWFi	ười
uowfm	ườm
uoWFm	ườm
uowfn	ườn
uoWFn	ườn
uowfng	ường
uoWFng	ường
uowfu	ườu
uoWFu	ườu
uowi	ươi
uoWi	ươi
uowif	ười
uoWiF	ười
uowij	ượi
uoWiJ	ượi
uowir	ưởi
uoWiR	ưởi
uowis	ưới
uoWiS	ưới
uowix	ưỡi
uoWiX	ưỡi
uowj	ượ
uoWJ	ượ
Uowj	Ượ
UoWJ	Ượ
UOwj	ƯỢ
UOWJ	ƯỢ
uowjc	ược
uoWJc	ược
uowji	ượi
uoWJi	ượi
uowjm	ượm
uoWJm	ượm
uowjn	ượn
uoWJn	ượn
uowjng	ượng
uoWJng	ượng
uowjp	ượp
uoWJp	ượp
uowjt	ượt
uoWJt	ượt
uowju	ượu
uoWJu	ượu
uowm	ươm
uoWm	ươm
uowmf	ườm
uoWmF	ườm
uowmj	ượm
uoWmJ	ượm
uowmr	ưởm
uoWmR	ưởm
uowms	ướm
uoWmS	ướm
uowmx	ưỡm
uoWmX	ưỡm
uown	ươn
uoWn	ươn
uownf	ườn
uoWnF	ườn
uowng	ương
uoWng	ương
uowngf	ường
uoWngF	ường
uowngj	ượng
uoWngJ	ượng
uowngr	ưởng
uoWngR	ưởng
uowngs	ướng
uoWngS	ướng
uowngx	ưỡng
uoWngX	ưỡng
uownj	ượn
uoWnJ	ượn
uownr	ưởn
uoWnR	ưởn
uowns	ướn
uoWnS	ướn
uownx	ưỡn
uoWnX	ưỡn
uowp	ươp
uoWp	ươp
uowpj	ượp
uoWpJ	ượp
uowps	ướp
uoWpS	ướp
uowr	ưở
uoWR	ưở
Uowr	Ưở
UoWR	Ưở
UOwr	ƯỞ
UOWR	ƯỞ
uowri	ưởi
uoWRi	ưởi
uowrm	ưởm
uoWRm	ưởm
uowrn	ưởn
uoWRn	ưởn
uowrng	ưởng
uoWRng	ưởng
uowru	ưởu
uoWRu	ưởu
uows	ướ
uoWS	ướ
Uows	Ướ
UoWS	Ướ
UOws	ƯỚ
UOWS	ƯỚ
uowsc	ước
uoWSc	ước
uowsi	ưới
uoWSi	ưới
uowsm	ướm
uoWSm	ướm
uowsn	ướn
uoWSn	ướn
uowsng	ướng
uoWSng	ướng
uowsp	ướp
uoWSp	ướp
uowst	ướt
uoWSt	ướt
uowsu	ướu
uoWSu	ướu
uowt	ươt
uoWt	ươt
uowtj	ượt
uoWtJ	ượt
uowts	ướt
uoWtS	ướt
uowu	ươu
uoWu	ươu
uowuf	ườu
uoWuF	ườu
uowuj	ượu
uoWuJ	ượu
uowur	ưởu
uoWuR	ưởu
uowus	ướu
uoWuS	ướu
uowux	ưỡu
uoWuX	ưỡu
uowx	ưỡ
uoWX	ưỡ
Uowx	Ưỡ
UoWX	Ưỡ
UOwx	ƯỠ
UOWX	ƯỠ
uowxi	ưỡi
uoWXi	ưỡi
uowxm	ưỡm
uoWXm	ưỡm
uowxn	ưỡn
uoWXn	ưỡn
uowxng	ưỡng
uoWXng	ưỡng
uowxu	ưỡu
uoWXu	ưỡu
up	up
Up	Up
UP	UP
upj	ụp
upJ	ụp
Upj	Ụp
UpJ	Ụp
UPj	ỤP
UPJ	ỤP
ups	úp
upS	úp
Ups	Úp
UpS	Úp
UPs	ÚP
UPS	ÚP
ur	ủ
uR	ủ
Ur	Ủ
UR	Ủ
ura	ủa
uRa	ủa
Ura	Ủa
UrA	ỦA
URa	Ủa
URA	ỦA
uri	ủi
uRi	ủi
Uri	Ủi
UrI	ỦI
URi	Ủi
URI	ỦI
urm	ủm
uRm	ủm
Urm	Ủm
UrM	ỦM
URm	Ủm
URM	ỦM
urn	ủn
uRn	ủn
Urn	Ủn
UrN	ỦN
URn	Ủn
URN	ỦN
urng	ủng
uRng	ủng
Urng	Ủng
UrNG	ỦNG
URng	Ủng
URNG	ỦNG
us	ú
uS	ú
Us	Ú
US	Ú
usa	úa
uSa	úa
Usa	Úa
UsA	ÚA
USa	Úa
USA	ÚA
usc	úc
uSc	úc
Usc	Úc
UsC	ÚC
USc	Úc
USC	ÚC
usi	úi
uSi	úi
Usi	Úi
UsI	ÚI
USi	Úi
USI	ÚI
usm	úm
uSm	úm
Usm	Úm
UsM	ÚM
USm	Úm
USM	ÚM
usn	ún
uSn	ún
Usn	Ún
UsN	ÚN
USn	Ún
USN	ÚN
usng	úng
uSng	úng
Usng	Úng
UsNG	ÚNG
USng	Úng
USNG	ÚNG
usp	úp
uSp	úp
Usp	Úp
UsP	ÚP
USp	Úp
USP	ÚP
ust	út
uSt	út
Ust	Út
UsT	ÚT
USt	Út
UST	ÚT
ut	ut
Ut	Ut
UT	UT
utj	ụt
utJ	ụt
Utj	Ụt
UtJ	Ụt
UTj	ỤT
UTJ	ỤT
uts	út
utS	út
Uts	Út
UtS	Út
UTs	ÚT
UTS	ÚT
uw	ư
uW	ư
Uw	Ư
UW	Ư
uwa	ưa
uWa	ưa
Uwa	Ưa
UwA	ƯA
UWa	Ưa
UWA	ƯA
uwaf	ừa
uWaF	ừa
Uwaf	Ừa
UwAf	ỪA
UWaF	Ừa
UWAF	ỪA
uwaj	ựa
uWaJ	ựa
Uwaj	Ựa
UwAj	ỰA
UWaJ	Ựa
UWAJ	ỰA
uwar	ửa
uWaR	ửa
Uwar	Ửa
UwAr	ỬA
UWaR	Ửa
UWAR	ỬA
uwas	ứa
uWaS	ứa
Uwas	Ứa
UwAs	ỨA
UWaS	Ứa
UWAS	ỨA
uwax	ữa
uWaX	ữa
Uwax	Ữa
UwAx	ỮA
UWaX	Ữa
UWAX	ỮA
uwc	ưc
uWc	ưc
Uwc	Ưc
UwC	ƯC
UWc	Ưc
UWC	ƯC
uwcj	ực
uWcJ	ực
Uwcj	Ực
UwCj	ỰC
UWcJ	Ực
UWCJ	ỰC
uwcs	ức
uWcS	ức
Uwcs	Ức
UwCs	ỨC
UWcS	Ức
UWCS	ỨC
uwf	ừ
uWF	ừ
Uwf	Ừ
UWF	Ừ
uwfa	ừa
uWFa	ừa
Uwfa	Ừa
UwfA	ỪA
UWFa	Ừa
UWFA	ỪA
uwfi	ừi
uWFi	ừi
Uwfi	Ừi
UwfI	ỪI
UWFi	Ừi
UWFI	ỪI
uwfm	ừm
uWFm	ừm
Uwfm	Ừm
UwfM	ỪM
UWFm	Ừm
UWFM	ỪM
uwfng	ừng
uWFng	ừng
Uwfng	Ừng
UwfNG	ỪNG
UWFng	Ừng
UWFNG	ỪNG
uwfu	ừu
uWFu	ừu
Uwfu	Ừu
UwfU	ỪU
UWFu	Ừu
UWFU	ỪU
uwi	ưi
uWi	ưi
Uwi	Ưi
UwI	ƯI
UWi	Ưi
UWI	ƯI
uwif	ừi
uWiF	ừi
Uwif	Ừi
UwIf	ỪI
UWiF	Ừi
UWIF	ỪI
uwij	ựi
uWiJ	ựi
Uwij	Ựi
UwIj	ỰI
UWiJ	Ựi
UWIJ	ỰI
uwir	ửi
uWiR	ửi
Uwir	Ửi
UwIr	ỬI
UWiR	Ửi
UWIR	ỬI
uwis	ứi
uWiS	ứi
Uwis	Ứi
UwIs	ỨI
UWiS	Ứi
UWIS	ỨI
uwix	ữi
uWiX	ữi
Uwix	Ữi
UwIx	ỮI
UWiX	Ữi
UWIX	ỮI
uwj	ự
uWJ	ự
Uwj	Ự
UWJ	Ự
uwja	ựa
uWJa	ựa
Uwja	Ựa
UwjA	ỰA
UWJa	Ựa
UWJA	ỰA
uwjc	ực
uWJc	ực
Uwjc	Ực
UwjC	ỰC
UWJc	Ực
UWJC	ỰC
uwji	ựi
uWJi	ựi
Uwji	Ựi
UwjI	ỰI
UWJi	Ựi
UWJI	ỰI
uwjm	ựm
uWJm	ựm
Uwjm	Ựm
UwjM	ỰM
UWJm	Ựm
UWJM	ỰM
uwjng	ựng
uWJng	ựng
Uwjng	Ựng
UwjNG	ỰNG
UWJng	Ựng
UWJNG	ỰNG
uwjt	ựt
uWJt	ựt
Uwjt	Ựt
UwjT	ỰT
UWJt	Ựt
UWJT	ỰT
uwju	ựu
uWJu	ựu
Uwju	Ựu
UwjU	ỰU
UWJu	Ựu
UWJU	ỰU
uwm	ưm
uWm	ưm
Uwm	Ưm
UwM	ƯM
UWm	Ưm
UWM	ƯM
uwmf	ừm
uWmF	ừm
Uwmf	Ừm
UwMf	ỪM
UWmF	Ừm
UWMF	ỪM
uwmj	ựm
uWmJ	ựm
Uwmj	Ựm
UwMj	ỰM
UWmJ	Ựm
UWMJ	ỰM
uwmr	ửm
uWmR	ửm
Uwmr	Ửm
UwMr	ỬM
UWmR	Ửm
UWMR	ỬM
uwms	ứm
uWmS	ứm
Uwms	Ứm
UwMs	ỨM
UWmS	Ứm
UWMS	ỨM
uwmx	ữm
uWmX	ữm
Uwmx	Ữm
UwMx	ỮM
UWmX	Ữm
UWMX	ỮM
uwng	ưng
uWng	ưng
Uwng	Ưng
UwNG	ƯNG
UWng	Ưng
UWNG	ƯNG
uwngf	ừng
uWngF	ừng
Uwngf	Ừng
UwNGf	ỪNG
UWngF	Ừng
UWNGF	ỪNG
uwngj	ựng
uWngJ	ựng
Uwngj	Ựng
UwNGj	ỰNG
UWngJ	Ựng
UWNGJ	ỰNG
uwngr	ửng
uWngR	ửng
Uwngr	Ửng
UwNGr	ỬNG
UWngR	Ửng
UWNGR	ỬNG
uwngs	ứng
uWngS	ứng
Uwngs	Ứng
UwNGs	ỨNG
UWngS	Ứng
UWNGS	ỨNG
uwngx	ững
uWngX	ững
Uwngx	Ững
UwNGx	ỮNG
UWngX	Ững
UWNGX	ỮNG
uwowc	ươc
uWoWc	ươc
Uwowc	Ươc
UwOwC	ƯƠC
UWoWc	Ươc
UWOWC	ƯƠC
uwowcj	ược
uWoWcJ	ược
Uwowcj	Ược
UwOwCj	ƯỢC
UWoWcJ	Ược
UWOWCJ	ƯỢC
uwowcs	ước
uWoWcS	ước
Uwowcs	Ước
UwOwCs	ƯỚC
UWoWcS	Ước
UWOWCS	ƯỚC
uwowfi	ười
uWoWFi	ười
Uwowfi	Ười
UwOwfI	ƯỜI
UWoWFi	Ười
UWOWFI	ƯỜI
uwowfm	ườm
uWoWFm	ườm
Uwowfm	Ườm
UwOwfM	ƯỜM
UWoWFm	Ườm
UWOWFM	ƯỜM
uwowfn	ườn
uWoWFn	ườn
Uwowfn	Ườn
UwOwfN	ƯỜN
UWoWFn	Ườn
UWOWFN	ƯỜN
uwowfng	ường
uWoWFng	ường
Uwowfng	Ường
UwOwfNG	ƯỜNG
UWoWFng	Ường
UWOWFNG	ƯỜNG
uwowfu	ườu
uWoWFu	ườu
Uwowfu	Ườu
UwOwfU	ƯỜU
UWoWFu	Ườu
UWOWFU	ƯỜU
uwowi	ươi
uWoWi	ươi
Uwowi	Ươi
UwOwI	ƯƠI
UWoWi	Ươi
UWOWI	ƯƠI
uwowif	ười
uWoWiF	ười
Uwowif	Ười
UwOwIf	ƯỜI
UWoWiF	Ười
UWOWIF	ƯỜI
uwowij	ượi
uWoWiJ	ượi
Uwowij	Ượi
UwOwIj	ƯỢI
UWoWiJ	Ượi
UWOWIJ	ƯỢI
uwowir	ưởi
uWoWiR	ưởi
Uwowir	Ưởi
UwOwIr	ƯỞI
UWoWiR	Ưởi
UWOWIR	ƯỞI
uwowis	ưới
uWoWiS	ưới
Uwowis	Ưới
UwOwIs	ƯỚI
UWoWiS	Ưới
UWOWIS	ƯỚI
uwowix	ưỡi
uWoWiX	ưỡi
Uwowix	Ưỡi
UwOwIx	ƯỠI
UWoWiX	Ưỡi
UWOWIX	ƯỠI
uwowjc	ược
uWoWJc	ược
Uwowjc	Ược
UwOwjC	ƯỢC
UWoWJc	Ược
UWOWJC	ƯỢC
uwowji	ượi
uWoWJi	ượi
Uwowji	Ượi
UwOwjI	ƯỢI
UWoWJi	Ượi
UWOWJI	ƯỢI
uwowjm	ượm
uWoWJm	ượm
Uwowjm	Ượm
UwOwjM	ƯỢM
UWoWJm	Ượm
UWOWJM	ƯỢM
uwowjn	ượn
uWoWJn	ượn
Uwowjn	Ượn
UwOwjN	ƯỢN
UWoWJn	Ượn
UWOWJN	ƯỢN
uwowjng	ượng
uWoWJng	ượng
Uwowjng	Ượng
UwOwjNG	ƯỢNG
UWoWJng	Ượng
UWOWJNG	ƯỢNG
uwowjp	ượp
uWoWJp	ượp
Uwowjp	Ượp
UwOwjP	ƯỢP
UWoWJp	Ượp
UWOWJP	ƯỢP
uwowjt	ượt
uWoWJt	ượt
Uwowjt	Ượt
UwOwjT	ƯỢT
UWoWJt	Ượt
UWOWJT	ƯỢT
uwowju	ượu
uWoWJu	ượu
Uwowju	Ượu
UwOwjU	ƯỢU
UWoWJu	Ượu
UWOWJU	ƯỢU
uwowm	ươm
uWoWm	ươm
Uwowm	Ươm
UwOwM	ƯƠM
UWoWm	Ươm
UWOWM	ƯƠM
uwowmf	ườm
uWoWmF	ườm
Uwowmf	Ườm
UwOwMf	ƯỜM
UWoWmF	Ườm
UWOWMF	ƯỜM
uwowmj	ượm
uWoWmJ	ượm
Uwowmj	Ượm
UwOwMj	ƯỢM
UWoWmJ	Ượm
UWOWMJ	ƯỢM
uwowmr	ưởm
uWoWmR	ưởm
Uwowmr	Ưởm
UwOwMr	ƯỞM
UWoWmR	Ưởm
UWOWMR	ƯỞM
uwowms	ướm
uWoWmS	ướm
Uwowms	Ướm
UwOwMs	ƯỚM
UWoWmS	Ướm
UWOWMS	ƯỚM
uwowmx	ưỡm
uWoWmX	ưỡm
Uwowmx	Ưỡm
UwOwMx	ƯỠM
UWoWmX	Ưỡm
UWOWMX	ƯỠM
uwown	ươn
uWoWn	ươn
Uwown	Ươn
UwOwN	ƯƠN
UWoWn	Ươn
UWOWN	ƯƠN
uwownf	ườn
uWoWnF	ườn
Uwownf	Ườn
UwOwNf	ƯỜN
UWoWnF	Ườn
UWOWNF	ƯỜN
uwowng	ương
uWoWng	ương
Uwowng	Ương
UwOwNG	ƯƠNG
UWoWng	Ương
UWOWNG	ƯƠNG
uwowngf	ường
uWoWngF	ường
Uwowngf	Ường
UwOwNGf	ƯỜNG
UWoWngF	Ường
UWOWNGF	ƯỜNG
uwowngj	ượng
uWoWngJ	ượng
Uwowngj	Ượng
UwOwNGj	ƯỢNG
UWoWngJ	Ượng
UWOWNGJ	ƯỢNG
uwowngr	ưởng
uWoWngR	ưởng
Uwowngr	Ưởng
UwOwNGr	ƯỞNG
UWoWngR	Ưởng
UWOWNGR	ƯỞNG
uwowngs	ướng
uWoWngS	ướng
Uwowngs	Ướng
UwOwNGs	ƯỚNG
UWoWngS	Ướng
UWOWNGS	ƯỚNG
uwowngx	ưỡng
uWoWngX	ưỡng
Uwowngx	Ưỡng
UwOwNGx	ƯỠNG
UWoWngX	Ưỡng
UWOWNGX	ƯỠNG
uwownj	ượn
uWoWnJ	ượn
Uwownj	Ượn
UwOwNj	ƯỢN
UWoWnJ	Ượn
UWOWNJ	ƯỢN
uwownr	ưởn
uWoWnR	ưởn
Uwownr	Ưởn
UwOwNr	ƯỞN
UWoWnR	Ưởn
UWOWNR	ƯỞN
uwowns	ướn
uWoWnS	ướn
Uwowns	Ướn
UwOwNs	ƯỚN
UWoWnS	Ướn
UWOWNS	ƯỚN
uwownx	ưỡn
uWoWnX	ưỡn
Uwownx	Ưỡn
UwOwNx	ƯỠN
UWoWnX	Ưỡn
UWOWNX	ƯỠN
uwowp	ươp
uWoWp	ươp
Uwowp	Ươp
UwOwP	ƯƠP
UWoWp	Ươp
UWOWP	ƯƠP
uwowpj	ượp
uWoWpJ	ượp
Uwowpj	Ượp
UwOwPj	ƯỢP
UWoWpJ	Ượp
UWOWPJ	ƯỢP
uwowps	ướp
uWoWpS	ướp
Uwowps	Ướp
UwOwPs	ƯỚP
UWoWpS	Ướp
UWOWPS	ƯỚP
uwowri	ưởi
uWoWRi	ưởi
Uwowri	Ưởi
UwOwrI	ƯỞI
UWoWRi	Ưởi
UWOWRI	ƯỞI
uwowrm	ưởm
uWoWRm	ưởm
Uwowrm	Ưởm
UwOwrM	ƯỞM
UWoWRm	Ưởm
UWOWRM	ƯỞM
uwowrn	ưởn
uWoWRn	ưởn
Uwowrn	Ưởn
UwOwrN	ƯỞN
UWoWRn	Ưởn
UWOWRN	ƯỞN
uwowrng	ưởng
uWoWRng	ưởng
Uwowrng	Ưởng
UwOwrNG	ƯỞNG
UWoWRng	Ưởng
UWOWRNG	ƯỞNG
uwowru	ưởu
uWoWRu	ưởu
Uwowru	Ưởu
UwOwrU	ƯỞU
UWoWRu	Ưởu
UWOWRU	ƯỞU
uwowsc	ước
uWoWSc	ước
Uwowsc	Ước
UwOwsC	ƯỚC
UWoWSc	Ước
UWOWSC	ƯỚC
uwowsi	ưới
uWoWSi	ưới
Uwowsi	Ưới
UwOwsI	ƯỚI
UWoWSi	Ưới
UWOWSI	ƯỚI
uwowsm	ướm
uWoWSm	ướm
Uwowsm	Ướm
UwOwsM	ƯỚM
UWoWSm	Ướm
UWOWSM	ƯỚM
uwowsn	ướn
uWoWSn	ướn
Uwowsn	Ướn
UwOwsN	ƯỚN
UWoWSn	Ướn
UWOWSN	ƯỚN
uwowsng	ướng
uWoWSng	ướng
Uwowsng	Ướng
UwOwsNG	ƯỚNG
UWoWSng	Ướng
UWOWSNG	ƯỚNG
uwowsp	ướp
uWoWSp	ướp
Uwowsp	Ướp
UwOwsP	ƯỚP
UWoWSp	Ướp
UWOWSP	ƯỚP
uwowst	ướt
uWoWSt	ướt
Uwowst	Ướt
UwOwsT	ƯỚT
UWoWSt	Ướt
UWOWST	ƯỚT
uwowsu	ướu
uWoWSu	ướu
Uwowsu	Ướu
UwOwsU	ƯỚU
UWoWSu	Ướu
UWOWSU	ƯỚU
uwowt	ươt
uWoWt	ươt
Uwowt	Ươt
UwOwT	ƯƠT
UWoWt	Ươt
UWOWT	ƯƠT
uwowtj	ượt
uWoWtJ	ượt
Uwowtj	Ượt
UwOwTj	ƯỢT
UWoWtJ	Ượt
UWOWTJ	ƯỢT
uwowts	ướt
uWoWtS	ướt
Uwowts	Ướt
UwOwTs	ƯỚT
UWoWtS	Ướt
UWOWTS	ƯỚT
uwowu	ươu
uWoWu	ươu
Uwowu	Ươu
UwOwU	ƯƠU
UWoWu	Ươu
UWOWU	ƯƠU
uwowuf	ườu
uWoWuF	ườu
Uwowuf	Ườu
UwOwUf	ƯỜU
UWoWuF	Ườu
UWOWUF	ƯỜU
uwowuj	ượu
uWoWuJ	ượu
Uwowuj	Ượu
UwOwUj	ƯỢU
UWoWuJ	Ượu
UWOWUJ	ƯỢU
uwowur	ưởu
uWoWuR	ưởu
Uwowur	Ưởu
UwOwUr	ƯỞU
UWoWuR	Ưởu
UWOWUR	ƯỞU
uwowus	ướu
uWoWuS	ướu
Uwowus	Ướu
UwOwUs	ƯỚU
UWoWuS	Ướu
UWOWUS	ƯỚU
uwowux	ưỡu
uWoWuX	ưỡu
Uwowux	Ưỡu
UwOwUx	ƯỠU
UWoWuX	Ưỡu
UWOWUX	ƯỠU
uwowxi	ưỡi
uWoWXi	ưỡi
Uwowxi	Ưỡi
UwOwxI	ƯỠI
UWoWXi	Ưỡi
UWOWXI	ƯỠI
uwowxm	ưỡm
uWoWXm	ưỡm
Uwowxm	Ưỡm
UwOwxM	ƯỠM
UWoWXm	Ưỡm
UWOWXM	ƯỠM
uwowxn	ưỡn
uWoWXn	ưỡn
Uwowxn	Ưỡn
UwOwxN	ƯỠN
UWoWXn	Ưỡn
UWOWXN	ƯỠN
uwowxng	ưỡng
uWoWXng	ưỡng
Uwowxng	Ưỡng
UwOwxNG	ƯỠNG
UWoWXng	Ưỡng
UWOWXNG	ƯỠNG
uwowxu	ưỡu
uWoWXu	ưỡu
Uwowxu	Ưỡu
UwOwxU	ƯỠU
UWoWXu	Ưỡu
UWOWXU	ƯỠU
uwr	ử
uWR	ử
Uwr	Ử
UWR	Ử
uwra	ửa
uWRa	ửa
Uwra	Ửa
UwrA	ỬA
UWRa	Ửa
UWRA	ỬA
uwri	ửi
uWRi	ửi
Uwri	Ửi
UwrI	ỬI
UWRi	Ửi
UWRI	ỬI
uwrm	ửm
uWRm	ửm
Uwrm	Ửm
UwrM	ỬM
UWRm	Ửm
UWRM	ỬM
uwrng	ửng
uWRng	ửng
Uwrng	Ửng
UwrNG	ỬNG
UWRng	Ửng
UWRNG	ỬNG
uwru	ửu
uWRu	ửu
Uwru	Ửu
UwrU	ỬU
UWRu	Ửu
UWRU	ỬU
uws	ứ
uWS	ứ
Uws	Ứ
UWS	Ứ
uwsa	ứa
uWSa	ứa
Uwsa	Ứa
UwsA	ỨA
UWSa	Ứa
UWSA	ỨA
uwsc	ức
uWSc	ức
Uwsc	Ức
UwsC	ỨC
UWSc	Ức
UWSC	ỨC
uwsi	ứi
uWSi	ứi
Uwsi	Ứi
UwsI	ỨI
UWSi	Ứi
UWSI	ỨI
uwsm	ứm
uWSm	ứm
Uwsm	Ứm
UwsM	ỨM
UWSm	Ứm
UWSM	ỨM
uwsng	ứng
uWSng	ứng
Uwsng	Ứng
UwsNG	ỨNG
UWSng	Ứng
UWSNG	ỨNG
uwst	ứt
uWSt	ứt
Uwst	Ứt
UwsT	ỨT
UWSt	Ứt
UWST	ỨT
uwsu	ứu
uWSu	ứu
Uwsu	Ứu
UwsU	ỨU
UWSu	Ứu
UWSU	ỨU
uwt	ưt
uWt	ưt
Uwt	Ưt
UwT	ƯT
UWt	Ưt
UWT	ƯT
uwtj	ựt
uWtJ	ựt
Uwtj	Ựt
UwTj	ỰT
UWtJ	Ựt
UWTJ	ỰT
uwts	ứt
uWtS	ứt
Uwts	Ứt
UwTs	ỨT
UWtS	Ứt
UWTS	ỨT
uwu	ưu
uWu	ưu
Uwu	Ưu
UwU	ƯU
UWu	Ưu
UWU	ƯU
uwuf	ừu
uWuF	ừu
Uwuf	Ừu
UwUf	ỪU
UWuF	Ừu
UWUF	ỪU
uwuj	ựu
uWuJ	ựu
Uwuj	Ựu
UwUj	ỰU
UWuJ	Ựu
UWUJ	ỰU
uwur	ửu
uWuR	ửu
Uwur	Ửu
UwUr	ỬU
UWuR	Ửu
UWUR	ỬU
uwus	ứu
uWuS	ứu
Uwus	Ứu
UwUs	ỨU
UWuS	Ứu
UWUS	ỨU
uwux	ữu
uWuX	ữu
Uwux	Ữu
UwUx	ỮU
UWuX	Ữu
UWUX	ỮU
uwx	ữ
uWX	ữ
Uwx	Ữ
UWX	Ữ
uwxa	ữa
uWXa	ữa
Uwxa	Ữa
UwxA	ỮA
UWXa	Ữa
UWXA	ỮA
uwxi	ữi
uWXi	ữi
Uwxi	Ữi
UwxI	ỮI
UWXi	Ữi
UWXI	ỮI
uwxm	ữm
uWXm	ữm
Uwxm	Ữm
UwxM	ỮM
UWXm	Ữm
UWXM	ỮM
uwxng	ững
uWXng	ững
Uwxng	Ững
UwxNG	ỮNG
UWXng	Ững
UWXNG	ỮNG
uwxu	ữu
uWXu	ữu
Uwxu	Ữu
UwxU	ỮU
UWXu	Ữu
UWXU	ỮU
ux	ũ
uX	ũ
Ux	Ũ
UX	Ũ
uxa	ũa
uXa	ũa
Uxa	Ũa
UxA	ŨA
UXa	Ũa
UXA	ŨA
uxi	ũi
uXi	ũi
Uxi	Ũi
UxI	ŨI
UXi	Ũi
UXI	ŨI
uxm	ũm
uXm	ũm
Uxm	Ũm
UxM	ŨM
UXm	Ũm
UXM	ŨM
uxn	ũn
uXn	ũn
Uxn	Ũn
UxN	ŨN
UXn	Ũn
UXN	ŨN
uxng	ũng
uXng	ũng
Uxng	Ũng
UxNG	ŨNG
UXng	Ũng
UXNG	ŨNG
uy	uy
Uy	Uy
UY	UY
uych	uych
Uych	Uych
UYCH	UYCH
uychj	uỵch
uychJ	uỵch
Uychj	Uỵch
UychJ	Uỵch
UYCHj	UỴCH
UYCHJ	UỴCH
uychs	uých
uychS	uých
Uychs	Uých
UychS	Uých
UYCHs	UÝCH
UYCHS	UÝCH
uyeefn	uyền
uyeeFn	uyền
Uyeefn	Uyền
UyeeFn	Uyền
UYEefN	UYỀN
UYEEFN	UYỀN
uyeejn	uyện
uyeeJn	uyện
Uyeejn	Uyện
UyeeJn	Uyện
UYEejN	UYỆN
UYEEJN	UYỆN
uyeejt	uyệt
uyeeJt	uyệt
Uyeejt	Uyệt
UyeeJt	Uyệt
UYEejT	UYỆT
UYEEJT	UYỆT
uyeen	uyên
Uyeen	Uyên
UYEeN	UYÊN
UYEEN	UYÊN
uyeenf	uyền
uyeenF	uyền
Uyeenf	Uyền
UyeenF	Uyền
UYEeNf	UYỀN
UYEENF	UYỀN
uyeenj	uyện
uyeenJ	uyện
Uyeenj	Uyện
UyeenJ	Uyện
UYEeNj	UYỆN
UYEENJ	UYỆN
uyeenr	uyển
uyeenR	uyển
Uyeenr	Uyển
UyeenR	Uyển
UYEeNr	UYỂN
UYEENR	UYỂN
uyeens	uyến
uyeenS	uyến
Uyeens	Uyến
UyeenS	Uyến
UYEeNs	UYẾN
UYEENS	UYẾN
uyeenx	uyễn
uyeenX	uyễn
Uyeenx	Uyễn
UyeenX	Uyễn
UYEeNx	UYỄN
UYEENX	UYỄN
uyeern	uyển
uyeeRn	uyển
Uyeern	Uyển
UyeeRn	Uyển
UYEerN	UYỂN
UYEERN	UYỂN
uyeesn	uyến
uyeeSn	uyến
Uyeesn	Uyến
UyeeSn	Uyến
UYEesN	UYẾN
UYEESN	UYẾN
uyeest	uyết
uyeeSt	uyết
Uyeest	Uyết
UyeeSt	Uyết
UYEesT	UYẾT
UYEEST	UYẾT
uyeet	uyêt
Uyeet	Uyêt
UYEeT	UYÊT
UYEET	UYÊT
uyeetj	uyệt
uyeetJ	uyệt
Uyeetj	Uyệt
UyeetJ	Uyệt
UYEeTj	UYỆT
UYEETJ	UYỆT
uyeets	uyết
uyeetS	uyết
Uyeets	Uyết
UyeetS	Uyết
UYEeTs	UYẾT
UYEETS	UYẾT
uyeexn	uyễn
uyeeXn	uyễn
Uyeexn	Uyễn
UyeeXn	Uyễn
UYEexN	UYỄN
UYEEXN	UYỄN
uyf	uỳ
uyF	uỳ
Uyf	Uỳ
UyF	Uỳ
UYf	UỲ
UYF	UỲ
uyfnh	uỳnh
uyFnh	uỳnh
Uyfnh	Uỳnh
UyFnh	Uỳnh
UYfNH	UỲNH
UYFNH	UỲNH
uyj	uỵ
uyJ	uỵ
Uyj	Uỵ
UyJ	Uỵ
UYj	UỴ
UYJ	UỴ
uyjch	uỵch
uyJch	uỵch
Uyjch	Uỵch
UyJch	Uỵch
UYjCH	UỴCH
UYJCH	UỴCH
uyjt	uỵt
uyJt	uỵt
Uyjt	Uỵt
UyJt	Uỵt
UYjT	UỴT
UYJT	UỴT
uynhf	uỳnh
uynhF	uỳnh
Uynhf	Uỳnh
UynhF	Uỳnh
UYNHf	UỲNH
UYNHF	UỲNH
uynhs	uýnh
uynhS	uýnh
Uynhs	Uýnh
UynhS	Uýnh
UYNHs	UÝNH
UYNHS	UÝNH
uyr	uỷ
uyR	uỷ
Uyr	Uỷ
UyR	Uỷ
UYr	UỶ
UYR	UỶ
uys	uý
uyS	uý
Uys	Uý
UyS	Uý
UYs	UÝ
UYS	UÝ
uysch	uých
uySch	uých
Uysch	Uých
UySch	Uých
UYsCH	UÝCH
UYSCH	UÝCH
uysnh	uýnh
uySnh	uýnh
Uysnh	Uýnh
UySnh	Uýnh
UYsNH	UÝNH
UYSNH	UÝNH
uyst	uýt
uySt	uýt
Uyst	Uýt
UySt	Uýt
UYsT	UÝT
UYST	UÝT
uyt	uyt
Uyt	Uyt
UYT	UYT
uytj	uỵt
uytJ	uỵt
Uytj	Uỵt
UytJ	Uỵt
UYTj	UỴT
UYTJ	UỴT
uyts	uýt
uytS	uýt
Uyts	Uýt
UytS	Uýt
UYTs	UÝT
UYTS	UÝT
uyx	uỹ
uyX	uỹ
Uyx	Uỹ
UyX	Uỹ
UYx	UỸ
UYX	UỸ
yf	ỳ
yF	ỳ
Yf	Ỳ
YF	Ỳ
yj	ỵ
yJ	ỵ
Yj	Ỵ
YJ	Ỵ
yr	ỷ
yR	ỷ
Yr	Ỷ
YR	Ỷ
ys	ý
yS	ý
Ys	Ý
YS	Ý
yx	ỹ
yX	ỹ
Yx	Ỹ
YX	Ỹ
